Value Date,Description,Ref No./Cheque No.,Debit,Credit,Balance
26 Jul 2024,BY TRANSFER-UPI/CR/447723293981/ROHIT T/HDFC/anitapawar/Dr Re--,TRANSFER FROM 9137022807,,4660.2,14660.2
22 Sep 2024,BY TRANSFER-UPI/CR/497546374344/MS SANJE/KKBK/spawar3290/Dr Re--,TRANSFER FROM 9137022807,,3988.09,18648.29
24 Sep 2024,BY TRANSFER-UPI/CR/457812481678/MS SANJE/SBIN/anitapawar/Dr Re--,TRANSFER FROM 9137022807,,628.2,19276.49
25 Jul 2024,TO TRANSFER-UPI/DR/489047368809/SAGAR MO/KKBK/rohit@okhdfc/UPI--,TRANSFER TO 7382910045,4372.36,,14904.13
6 Aug 2024,BY TRANSFER-UPI/CR/406610247446/ROHIT T/ICIC/anitapawar/Dr Re--,TRANSFER FROM 8974521398,,62.0,14966.13
15 Jul 2024,TO TRANSFER-UPI/DR/464561503955/SAMEER S/SBIN/write2same/UPI--,TRANSFER TO 8974521398,1053.65,,13912.48
25 Aug 2024,TO TRANSFER-UPI/DR/404318497331/PRIYA K/IDIB/rahuldixit/UPI--,TRANSFER TO 7382910045,620.46,,13292.02
1 Jul 2024,TO TRANSFER-UPI/DR/405725093549/PRIYA K/IDIB/spawar3290/UPI--,TRANSFER TO 4897732162091,4618.2,,8673.82
1 Sep 2024,BY TRANSFER-UPI/CR/410471761432/PRIYA K/HDFC/spawar3290/Dr Re--,TRANSFER FROM 8974521398,,4597.07,13270.89
1 Aug 2024,BY TRANSFER-UPI/CR/411674035943/PRIYA K/HDFC/rahuldixit/Dr Re--,TRANSFER FROM 7382910045,,3896.08,17166.97
11 Aug 2024,BY TRANSFER-UPI/CR/488872989508/ANITA P/ICIC/write2same/Dr Re--,TRANSFER FROM 8974521398,,4959.34,22126.31
18 Jul 2024,BY TRANSFER-UPI/CR/482281830456/MS SANJE/HDFC/spawar3290/Dr Re--,TRANSFER FROM 4897690162095,,2879.37,25005.68
23 Aug 2024,BY TRANSFER-UPI/CR/458804272559/SAMEER S/ICIC/spawar3290/Dr Re--,TRANSFER FROM 9137022807,,1199.74,26205.42
29 Aug 2024,BY TRANSFER-UPI/CR/413713396405/SAMEER S/ICIC/rahuldixit/Dr Re--,TRANSFER FROM 9137022807,,3854.5,30059.92
2 Sep 2024,TO TRANSFER-UPI/DR/405188466909/ANITA P/KKBK/spawar3290/UPI--,TRANSFER TO 4897732162091,2221.28,,27838.64
27 Sep 2024,TO TRANSFER-UPI/DR/441973406664/SAMEER S/ICIC/write2same/UPI--,TRANSFER TO 8974521398,70.17,,27768.47
30 Sep 2024,BY TRANSFER-UPI/CR/401847478380/SAMEER S/KKBK/spawar3290/Dr Re--,TRANSFER FROM 9137022807,,3099.12,30867.59
14 Sep 2024,TO TRANSFER-UPI/DR/411133002564/MS SANJE/IDIB/spawar3290/UPI--,TRANSFER TO 4897732162091,3971.91,,26895.68
27 Jul 2024,TO TRANSFER-UPI/DR/402115641718/RAHUL D/KKBK/spawar3290/UPI--,TRANSFER TO 8974521398,2055.2,,24840.48
11 Aug 2024,BY TRANSFER-UPI/CR/460936339891/RAHUL D/HDFC/write2same/Dr Re--,TRANSFER FROM 8974521398,,3084.53,27925.01
24 Aug 2024,TO TRANSFER-UPI/DR/450371651222/RAHUL D/IDIB/spawar3290/UPI--,TRANSFER TO 4897690162095,2964.01,,24961.0
16 Jul 2024,TO TRANSFER-UPI/DR/469097884379/SAGAR MO/ICIC/spawar3290/UPI--,TRANSFER TO 7382910045,2751.69,,22209.31
21 Sep 2024,TO TRANSFER-UPI/DR/499028787440/RAHUL D/ICIC/anitapawar/UPI--,TRANSFER TO 4897690162095,4529.52,,17679.79
9 Sep 2024,TO TRANSFER-UPI/DR/437406874025/SAMEER S/KKBK/write2same/UPI--,TRANSFER TO 4897690162095,3696.14,,13983.65
11 Sep 2024,TO TRANSFER-UPI/DR/406288522651/MS SANJE/HDFC/rohit@okhdfc/UPI--,TRANSFER TO 7382910045,2915.22,,11068.43
17 Aug 2024,TO TRANSFER-UPI/DR/467871689125/SAMEER S/SBIN/spawar3290/UPI--,TRANSFER TO 9137022807,1610.53,,9457.9
18 Jul 2024,TO TRANSFER-UPI/DR/430900278267/ROHIT T/HDFC/spawar3290/UPI--,TRANSFER TO 4897732162091,4665.19,,4792.71
10 Aug 2024,BY TRANSFER-UPI/CR/445503878761/MS SANJE/IDIB/write2same/Dr Re--,TRANSFER FROM 4897690162095,,3790.69,8583.4
5 Aug 2024,BY TRANSFER-UPI/CR/409274489240/SAGAR MO/IDIB/write2same/Dr Re--,TRANSFER FROM 4897690162095,,3747.08,12330.48
24 Sep 2024,TO TRANSFER-UPI/DR/430470116803/SAMEER S/IDIB/spawar3290/UPI--,TRANSFER TO 4897690162095,503.51,,11826.97
4 Jul 2024,BY TRANSFER-UPI/CR/462700022921/PRIYA K/ICIC/rohit@okhdfc/Dr Re--,TRANSFER FROM 8974521398,,3875.23,15702.2
12 Jul 2024,TO TRANSFER-UPI/DR/434814347530/MS SANJE/ICIC/rohit@okhdfc/UPI--,TRANSFER TO 8974521398,1714.46,,13987.74
30 Sep 2024,TO TRANSFER-UPI/DR/417143723391/MS SANJE/IDIB/rahuldixit/UPI--,TRANSFER TO 8974521398,4198.7,,9789.04
13 Jul 2024,TO TRANSFER-UPI/DR/462742199103/ROHIT T/SBIN/anitapawar/UPI--,TRANSFER TO 4897690162095,1872.04,,7917.0
2 Jul 2024,BY TRANSFER-UPI/CR/451113518919/ROHIT T/KKBK/rohit@okhdfc/Dr Re--,TRANSFER FROM 8974521398,,3105.22,11022.22
10 Sep 2024,BY TRANSFER-UPI/CR/440103309087/SAMEER S/HDFC/spawar3290/Dr Re--,TRANSFER FROM 9137022807,,2199.29,13221.51
17 Aug 2024,BY TRANSFER-UPI/CR/437140766241/PRIYA K/SBIN/spawar3290/Dr Re--,TRANSFER FROM 8974521398,,3053.58,16275.09
1 Sep 2024,TO TRANSFER-UPI/DR/463633432393/PRIYA K/HDFC/rohit@okhdfc/UPI--,TRANSFER TO 4897690162095,114.47,,16160.62
22 Jul 2024,TO TRANSFER-UPI/DR/484633497396/SAGAR MO/IDIB/rahuldixit/UPI--,TRANSFER TO 8974521398,3648.74,,12511.88
4 Jul 2024,TO TRANSFER-UPI/DR/459713713015/SAGAR MO/IDIB/spawar3290/UPI--,TRANSFER TO 4897690162095,792.39,,11719.49
2 Sep 2024,TO TRANSFER-UPI/DR/457076175128/ANITA P/HDFC/anitapawar/UPI--,TRANSFER TO 8974521398,2631.57,,9087.92
6 Jul 2024,TO TRANSFER-UPI/DR/473315557302/MS SANJE/ICIC/write2same/UPI--,TRANSFER TO 8974521398,3975.75,,5112.17
21 Aug 2024,TO TRANSFER-UPI/DR/417818500870/PRIYA K/SBIN/rahuldixit/UPI--,TRANSFER TO 4897732162091,3204.63,,1907.54
14 Sep 2024,BY TRANSFER-UPI/CR/464654943741/MS SANJE/HDFC/rahuldixit/Dr Re--,TRANSFER FROM 9137022807,,383.7,2291.24
28 Aug 2024,BY TRANSFER-UPI/CR/450662552298/ROHIT T/IDIB/rohit@okhdfc/Dr Re--,TRANSFER FROM 4897690162095,,3897.86,6189.1
31 Jul 2024,TO TRANSFER-UPI/DR/460987457702/SAGAR MO/ICIC/anitapawar/UPI--,TRANSFER TO 4897732162091,142.73,,6046.37
12 Aug 2024,TO TRANSFER-UPI/DR/402765600787/SAGAR MO/KKBK/spawar3290/UPI--,TRANSFER TO 7382910045,2059.24,,3987.13
23 Aug 2024,BY TRANSFER-UPI/CR/437023243696/RAHUL D/KKBK/anitapawar/Dr Re--,TRANSFER FROM 9137022807,,3900.4,7887.53
1 Aug 2024,BY TRANSFER-UPI/CR/431215702135/ROHIT T/HDFC/spawar3290/Dr Re--,TRANSFER FROM 4897732162091,,3783.28,11670.81
17 Sep 2024,BY TRANSFER-UPI/CR/478164402780/ANITA P/ICIC/anitapawar/Dr Re--,TRANSFER FROM 8974521398,,2455.4,14126.21
21 Jul 2024,BY TRANSFER-UPI/CR/458801416352/ANITA P/IDIB/anitapawar/Dr Re--,TRANSFER FROM 4897690162095,,2762.96,16889.17
26 Aug 2024,BY TRANSFER-UPI/CR/436215785835/RAHUL D/SBIN/anitapawar/Dr Re--,TRANSFER FROM 9137022807,,1958.2,18847.37
24 Sep 2024,TO TRANSFER-UPI/DR/484013000150/SAGAR MO/SBIN/rahuldixit/UPI--,TRANSFER TO 8974521398,4550.08,,14297.29
17 Jul 2024,BY TRANSFER-UPI/CR/434218661522/MS SANJE/HDFC/rahuldixit/Dr Re--,TRANSFER FROM 7382910045,,423.98,14721.27
17 Jul 2024,BY TRANSFER-UPI/CR/416072932413/ROHIT T/SBIN/write2same/Dr Re--,TRANSFER FROM 9137022807,,2320.15,17041.42
22 Aug 2024,BY TRANSFER-UPI/CR/479647644566/SAMEER S/SBIN/rohit@okhdfc/Dr Re--,TRANSFER FROM 9137022807,,668.32,17709.74
12 Aug 2024,TO TRANSFER-UPI/DR/427567339573/ANITA P/IDIB/rohit@okhdfc/UPI--,TRANSFER TO 9137022807,2855.14,,14854.6
8 Jul 2024,BY TRANSFER-UPI/CR/404724784429/SAGAR MO/IDIB/rohit@okhdfc/Dr Re--,TRANSFER FROM 7382910045,,1685.1,16539.7
26 Jul 2024,TO TRANSFER-UPI/DR/409643507212/SAGAR MO/IDIB/write2same/UPI--,TRANSFER TO 4897732162091,596.59,,15943.11
25 Aug 2024,TO TRANSFER-UPI/DR/478775180864/PRIYA K/KKBK/rohit@okhdfc/UPI--,TRANSFER TO 9137022807,1406.32,,14536.79
9 Sep 2024,TO TRANSFER-UPI/DR/428524249032/ROHIT T/KKBK/spawar3290/UPI--,TRANSFER TO 9137022807,1160.46,,13376.33
10 Jul 2024,BY TRANSFER-UPI/CR/418335147337/ANITA P/HDFC/rahuldixit/Dr Re--,TRANSFER FROM 9137022807,,1389.81,14766.14
20 Sep 2024,TO TRANSFER-UPI/DR/438995943874/RAHUL D/SBIN/anitapawar/UPI--,TRANSFER TO 4897732162091,2509.16,,12256.98
26 Sep 2024,TO TRANSFER-UPI/DR/454669455608/PRIYA K/HDFC/write2same/UPI--,TRANSFER TO 8974521398,3995.57,,8261.41
24 Sep 2024,BY TRANSFER-UPI/CR/458705322401/MS SANJE/IDIB/spawar3290/Dr Re--,TRANSFER FROM 9137022807,,429.93,8691.34
4 Aug 2024,TO TRANSFER-UPI/DR/426562499022/RAHUL D/KKBK/rohit@okhdfc/UPI--,TRANSFER TO 9137022807,3679.46,,5011.88
18 Aug 2024,TO TRANSFER-UPI/DR/470938863862/ANITA P/ICIC/write2same/UPI--,TRANSFER TO 7382910045,4840.23,,171.65
30 Aug 2024,BY TRANSFER-UPI/CR/476265806113/RAHUL D/KKBK/rohit@okhdfc/Dr Re--,TRANSFER FROM 9137022807,,4575.51,4747.16
5 Jul 2024,TO TRANSFER-UPI/DR/427706929499/MS SANJE/SBIN/rohit@okhdfc/UPI--,TRANSFER TO 4897732162091,506.21,,4240.95
24 Sep 2024,TO TRANSFER-UPI/DR/424717389049/SAMEER S/SBIN/rohit@okhdfc/UPI--,TRANSFER TO 7382910045,4486.3,,-245.35
17 Sep 2024,TO TRANSFER-UPI/DR/420629025944/ANITA P/ICIC/anitapawar/UPI--,TRANSFER TO 8974521398,4225.86,,-4471.21
16 Sep 2024,TO TRANSFER-UPI/DR/486619261663/RAHUL D/KKBK/rahuldixit/UPI--,TRANSFER TO 4897732162091,1962.51,,-6433.72
30 Aug 2024,BY TRANSFER-UPI/CR/436299173334/ANITA P/KKBK/spawar3290/Dr Re--,TRANSFER FROM 4897732162091,,4339.38,-2094.34
21 Jul 2024,TO TRANSFER-UPI/DR/486343713884/SAMEER S/IDIB/rahuldixit/UPI--,TRANSFER TO 4897690162095,1960.87,,-4055.21
31 Aug 2024,TO TRANSFER-UPI/DR/417427049564/SAGAR MO/HDFC/rahuldixit/UPI--,TRANSFER TO 4897732162091,4922.55,,-8977.76
23 Jul 2024,BY TRANSFER-UPI/CR/485620591438/SAGAR MO/IDIB/rahuldixit/Dr Re--,TRANSFER FROM 9137022807,,325.78,-8651.98
1 Jul 2024,BY TRANSFER-UPI/CR/453290220827/SAMEER S/KKBK/write2same/Dr Re--,TRANSFER FROM 8974521398,,252.81,-8399.17
24 Jul 2024,TO TRANSFER-UPI/DR/492040402166/RAHUL D/HDFC/rohit@okhdfc/UPI--,TRANSFER TO 4897732162091,3319.48,,-11718.65
22 Sep 2024,BY TRANSFER-UPI/CR/437389389837/SAGAR MO/IDIB/rohit@okhdfc/Dr Re--,TRANSFER FROM 9137022807,,3451.64,-8267.01
16 Aug 2024,BY TRANSFER-UPI/CR/471988215179/ANITA P/SBIN/rohit@okhdfc/Dr Re--,TRANSFER FROM 8974521398,,2066.67,-6200.34
17 Sep 2024,BY TRANSFER-UPI/CR/476921036657/SAGAR MO/IDIB/write2same/Dr Re--,TRANSFER FROM 9137022807,,1985.77,-4214.57
20 Jul 2024,TO TRANSFER-UPI/DR/435496186676/ROHIT T/IDIB/rohit@okhdfc/UPI--,TRANSFER TO 4897690162095,4727.84,,-8942.41
3 Sep 2024,BY TRANSFER-UPI/CR/476534466556/SAGAR MO/HDFC/rohit@okhdfc/Dr Re--,TRANSFER FROM 7382910045,,2003.0,-6939.41
5 Jul 2024,BY TRANSFER-UPI/CR/476258152856/ROHIT T/SBIN/write2same/Dr Re--,TRANSFER FROM 7382910045,,4430.19,-2509.22
5 Sep 2024,TO TRANSFER-UPI/DR/441468835520/SAMEER S/IDIB/anitapawar/UPI--,TRANSFER TO 7382910045,3085.56,,-5594.78
19 Aug 2024,BY TRANSFER-UPI/CR/430672507019/SAMEER S/SBIN/rohit@okhdfc/Dr Re--,TRANSFER FROM 8974521398,,3833.76,-1761.02
21 Aug 2024,TO TRANSFER-UPI/DR/435524786748/ROHIT T/HDFC/anitapawar/UPI--,TRANSFER TO 4897690162095,3256.92,,-5017.94
17 Sep 2024,TO TRANSFER-UPI/DR/404607899207/MS SANJE/ICIC/spawar3290/UPI--,TRANSFER TO 8974521398,2823.83,,-7841.77
15 Jul 2024,TO TRANSFER-UPI/DR/475955924409/RAHUL D/SBIN/spawar3290/UPI--,TRANSFER TO 4897732162091,3896.37,,-11738.14
24 Sep 2024,BY TRANSFER-UPI/CR/451224886803/PRIYA K/HDFC/rahuldixit/Dr Re--,TRANSFER FROM 4897690162095,,1840.92,-9897.22
18 Jul 2024,BY TRANSFER-UPI/CR/404531777717/SAGAR MO/ICIC/rohit@okhdfc/Dr Re--,TRANSFER FROM 7382910045,,4065.21,-5832.01
21 Aug 2024,BY TRANSFER-UPI/CR/429442803041/SAMEER S/SBIN/anitapawar/Dr Re--,TRANSFER FROM 8974521398,,2650.84,-3181.17
22 Aug 2024,BY TRANSFER-UPI/CR/496419079389/SAGAR MO/KKBK/write2same/Dr Re--,TRANSFER FROM 4897732162091,,4818.28,1637.11
29 Aug 2024,TO TRANSFER-UPI/DR/455952696147/MS SANJE/IDIB/spawar3290/UPI--,TRANSFER TO 9137022807,2024.57,,-387.46
11 Sep 2024,BY TRANSFER-UPI/CR/434045591498/ANITA P/IDIB/anitapawar/Dr Re--,TRANSFER FROM 7382910045,,1208.64,821.18
2 Aug 2024,TO TRANSFER-UPI/DR/426260578240/ROHIT T/HDFC/anitapawar/UPI--,TRANSFER TO 9137022807,477.19,,343.99
8 Jul 2024,BY TRANSFER-UPI/CR/411376605911/RAHUL D/IDIB/anitapawar/Dr Re--,TRANSFER FROM 8974521398,,3335.05,3679.04
7 Jul 2024,BY TRANSFER-UPI/CR/466404150036/ROHIT T/IDIB/anitapawar/Dr Re--,TRANSFER FROM 7382910045,,1702.26,5381.3
27 Sep 2024,TO TRANSFER-UPI/DR/402855531604/ROHIT T/ICIC/anitapawar/UPI--,TRANSFER TO 4897690162095,4257.5,,1123.8
16 Sep 2024,TO TRANSFER-UPI/DR/463705802659/ANITA P/IDIB/write2same/UPI--,TRANSFER TO 7382910045,2664.71,,-1540.91
21 Sep 2024,TO TRANSFER-UPI/DR/466279962149/SAGAR MO/ICIC/anitapawar/UPI--,TRANSFER TO 4897690162095,4082.42,,-5623.33
18 Sep 2024,BY TRANSFER-UPI/CR/437665682832/MS SANJE/KKBK/spawar3290/Dr Re--,TRANSFER FROM 7382910045,,2805.26,-2818.07
24 Jul 2024,TO TRANSFER-UPI/DR/476938494047/SAGAR MO/IDIB/anitapawar/UPI--,TRANSFER TO 9137022807,3328.05,,-6146.12
28 Sep 2024,BY TRANSFER-UPI/CR/441073853617/SAGAR MO/KKBK/rahuldixit/Dr Re--,TRANSFER FROM 8974521398,,609.53,-5536.59
29 Aug 2024,BY TRANSFER-UPI/CR/402288936941/PRIYA K/SBIN/anitapawar/Dr Re--,TRANSFER FROM 7382910045,,4872.27,-664.32
26 Jul 2024,BY TRANSFER-UPI/CR/435103904142/SAMEER S/IDIB/rahuldixit/Dr Re--,TRANSFER FROM 4897732162091,,1197.67,533.35
15 Sep 2024,TO TRANSFER-UPI/DR/490692238902/SAMEER S/KKBK/spawar3290/UPI--,TRANSFER TO 8974521398,2727.43,,-2194.08
24 Aug 2024,BY TRANSFER-UPI/CR/481351836325/SAGAR MO/SBIN/anitapawar/Dr Re--,TRANSFER FROM 4897690162095,,4991.11,2797.03
23 Jul 2024,BY TRANSFER-UPI/CR/487512284593/MS SANJE/ICIC/write2same/Dr Re--,TRANSFER FROM 8974521398,,3197.77,5994.8
15 Aug 2024,BY TRANSFER-UPI/CR/433948120696/RAHUL D/KKBK/write2same/Dr Re--,TRANSFER FROM 4897732162091,,3990.99,9985.79
18 Jul 2024,BY TRANSFER-UPI/CR/486771663971/SAMEER S/KKBK/write2same/Dr Re--,TRANSFER FROM 9137022807,,4488.46,14474.25
11 Aug 2024,TO TRANSFER-UPI/DR/424237991831/SAGAR MO/KKBK/rahuldixit/UPI--,TRANSFER TO 9137022807,878.82,,13595.43
22 Sep 2024,TO TRANSFER-UPI/DR/444776150140/ANITA P/ICIC/write2same/UPI--,TRANSFER TO 8974521398,1642.19,,11953.24
11 Sep 2024,BY TRANSFER-UPI/CR/411336229932/ANITA P/SBIN/rohit@okhdfc/Dr Re--,TRANSFER FROM 4897690162095,,4991.33,16944.57
20 Sep 2024,BY TRANSFER-UPI/CR/408365477657/SAGAR MO/KKBK/rahuldixit/Dr Re--,TRANSFER FROM 4897690162095,,2339.38,19283.95
1 Sep 2024,BY TRANSFER-UPI/CR/455247737428/ROHIT T/ICIC/rohit@okhdfc/Dr Re--,TRANSFER FROM 4897690162095,,837.43,20121.38
2 Sep 2024,TO TRANSFER-UPI/DR/433575403880/ANITA P/ICIC/spawar3290/UPI--,TRANSFER TO 8974521398,4019.35,,16102.03
13 Aug 2024,TO TRANSFER-UPI/DR/413449791133/SAMEER S/IDIB/anitapawar/UPI--,TRANSFER TO 7382910045,4350.12,,11751.91
18 Jul 2024,TO TRANSFER-UPI/DR/487776538355/ANITA P/IDIB/rohit@okhdfc/UPI--,TRANSFER TO 4897732162091,955.22,,10796.69
28 Jul 2024,BY TRANSFER-UPI/CR/400865133758/SAGAR MO/ICIC/write2same/Dr Re--,TRANSFER FROM 7382910045,,2107.07,12903.76
12 Jul 2024,BY TRANSFER-UPI/CR/453810976979/RAHUL D/SBIN/anitapawar/Dr Re--,TRANSFER FROM 4897690162095,,326.98,13230.74
10 Sep 2024,TO TRANSFER-UPI/DR/426154923797/SAMEER S/HDFC/spawar3290/UPI--,TRANSFER TO 7382910045,2258.19,,10972.55
16 Jul 2024,BY TRANSFER-UPI/CR/424081290898/PRIYA K/ICIC/anitapawar/Dr Re--,TRANSFER FROM 7382910045,,1876.7,12849.25
29 Sep 2024,TO TRANSFER-UPI/DR/478464063017/RAHUL D/KKBK/spawar3290/UPI--,TRANSFER TO 4897732162091,1064.56,,11784.69
13 Sep 2024,TO TRANSFER-UPI/DR/457118254347/RAHUL D/SBIN/spawar3290/UPI--,TRANSFER TO 8974521398,2149.71,,9634.98
30 Jul 2024,BY TRANSFER-UPI/CR/492251547833/ROHIT T/HDFC/spawar3290/Dr Re--,TRANSFER FROM 4897690162095,,1827.43,11462.41
22 Aug 2024,BY TRANSFER-UPI/CR/415452634533/MS SANJE/ICIC/rahuldixit/Dr Re--,TRANSFER FROM 8974521398,,2319.8,13782.21
4 Aug 2024,BY TRANSFER-UPI/CR/458284792584/SAMEER S/KKBK/rohit@okhdfc/Dr Re--,TRANSFER FROM 7382910045,,2919.85,16702.06
2 Jul 2024,BY TRANSFER-UPI/CR/484410902032/ROHIT T/SBIN/write2same/Dr Re--,TRANSFER FROM 8974521398,,109.19,16811.25
30 Aug 2024,TO TRANSFER-UPI/DR/464350693456/RAHUL D/SBIN/rahuldixit/UPI--,TRANSFER TO 8974521398,895.49,,15915.76
8 Aug 2024,BY TRANSFER-UPI/CR/410551389816/SAMEER S/ICIC/rahuldixit/Dr Re--,TRANSFER FROM 9137022807,,3281.19,19196.95
4 Aug 2024,TO TRANSFER-UPI/DR/432507950963/ROHIT T/ICIC/spawar3290/UPI--,TRANSFER TO 8974521398,900.36,,18296.59
21 Sep 2024,BY TRANSFER-UPI/CR/497906054052/RAHUL D/HDFC/spawar3290/Dr Re--,TRANSFER FROM 4897690162095,,1612.55,19909.14
9 Jul 2024,BY TRANSFER-UPI/CR/447550602813/PRIYA K/ICIC/anitapawar/Dr Re--,TRANSFER FROM 9137022807,,2364.64,22273.78
1 Aug 2024,TO TRANSFER-UPI/DR/497521042931/SAMEER S/HDFC/write2same/UPI--,TRANSFER TO 4897732162091,4329.26,,17944.52
25 Aug 2024,BY TRANSFER-UPI/CR/475899149198/MS SANJE/SBIN/rohit@okhdfc/Dr Re--,TRANSFER FROM 4897732162091,,598.95,18543.47
14 Jul 2024,BY TRANSFER-UPI/CR/489694598903/ANITA P/ICIC/rohit@okhdfc/Dr Re--,TRANSFER FROM 9137022807,,1974.71,20518.18
27 Aug 2024,BY TRANSFER-UPI/CR/440649946832/ROHIT T/HDFC/spawar3290/Dr Re--,TRANSFER FROM 4897732162091,,1876.77,22394.95
6 Sep 2024,BY TRANSFER-UPI/CR/497553884290/SAMEER S/HDFC/rohit@okhdfc/Dr Re--,TRANSFER FROM 7382910045,,1713.22,24108.17
7 Aug 2024,TO TRANSFER-UPI/DR/449728719273/RAHUL D/ICIC/rohit@okhdfc/UPI--,TRANSFER TO 7382910045,1733.9,,22374.27
13 Aug 2024,TO TRANSFER-UPI/DR/460081963817/SAMEER S/ICIC/rahuldixit/UPI--,TRANSFER TO 4897732162091,118.05,,22256.22
27 Aug 2024,TO TRANSFER-UPI/DR/495426950128/SAMEER S/SBIN/rahuldixit/UPI--,TRANSFER TO 9137022807,4801.67,,17454.55
11 Aug 2024,TO TRANSFER-UPI/DR/418711947745/MS SANJE/HDFC/rohit@okhdfc/UPI--,TRANSFER TO 4897732162091,329.71,,17124.84
17 Sep 2024,TO TRANSFER-UPI/DR/468733994415/SAGAR MO/KKBK/spawar3290/UPI--,TRANSFER TO 4897732162091,384.92,,16739.92
8 Jul 2024,TO TRANSFER-UPI/DR/457870358741/RAHUL D/SBIN/anitapawar/UPI--,TRANSFER TO 7382910045,4773.55,,11966.37
19 Sep 2024,BY TRANSFER-UPI/CR/419510066076/RAHUL D/SBIN/rahuldixit/Dr Re--,TRANSFER FROM 8974521398,,2844.29,14810.66
20 Sep 2024,TO TRANSFER-UPI/DR/471232626202/RAHUL D/IDIB/write2same/UPI--,TRANSFER TO 4897690162095,208.38,,14602.28
22 Aug 2024,BY TRANSFER-UPI/CR/435162272743/ANITA P/KKBK/rohit@okhdfc/Dr Re--,TRANSFER FROM 4897732162091,,1128.95,15731.23
18 Jul 2024,BY TRANSFER-UPI/CR/431893974865/RAHUL D/HDFC/spawar3290/Dr Re--,TRANSFER FROM 9137022807,,224.53,15955.76
28 Jul 2024,BY TRANSFER-UPI/CR/426452527422/ANITA P/KKBK/anitapawar/Dr Re--,TRANSFER FROM 4897690162095,,780.12,16735.88
29 Jul 2024,BY TRANSFER-UPI/CR/435455090987/MS SANJE/HDFC/anitapawar/Dr Re--,TRANSFER FROM 4897690162095,,4926.64,21662.52
29 Sep 2024,TO TRANSFER-UPI/DR/447100965132/MS SANJE/SBIN/write2same/UPI--,TRANSFER TO 7382910045,2529.81,,19132.71
9 Sep 2024,TO TRANSFER-UPI/DR/498030591272/RAHUL D/HDFC/anitapawar/UPI--,TRANSFER TO 7382910045,2425.46,,16707.25
2 Sep 2024,BY TRANSFER-UPI/CR/455561517442/PRIYA K/SBIN/spawar3290/Dr Re--,TRANSFER FROM 9137022807,,1005.91,17713.16
30 Aug 2024,TO TRANSFER-UPI/DR/430238887288/SAMEER S/ICIC/anitapawar/UPI--,TRANSFER TO 4897732162091,2088.51,,15624.65
27 Aug 2024,BY TRANSFER-UPI/CR/426661317953/SAMEER S/HDFC/rohit@okhdfc/Dr Re--,TRANSFER FROM 4897732162091,,2710.38,18335.03
29 Sep 2024,TO TRANSFER-UPI/DR/407102506059/RAHUL D/HDFC/rohit@okhdfc/UPI--,TRANSFER TO 4897690162095,3384.57,,14950.46
6 Sep 2024,BY TRANSFER-UPI/CR/414362114260/ANITA P/KKBK/rahuldixit/Dr Re--,TRANSFER FROM 9137022807,,3265.21,18215.67
24 Sep 2024,BY TRANSFER-UPI/CR/407966767806/PRIYA K/KKBK/spawar3290/Dr Re--,TRANSFER FROM 8974521398,,2673.61,20889.28
26 Aug 2024,BY TRANSFER-UPI/CR/434674981790/RAHUL D/HDFC/rohit@okhdfc/Dr Re--,TRANSFER FROM 9137022807,,3023.65,23912.93
31 Aug 2024,TO TRANSFER-UPI/DR/452276213270/ROHIT T/KKBK/write2same/UPI--,TRANSFER TO 4897732162091,892.87,,23020.06
11 Jul 2024,BY TRANSFER-UPI/CR/476849131154/MS SANJE/SBIN/write2same/Dr Re--,TRANSFER FROM 9137022807,,4938.8,27958.86
22 Aug 2024,BY TRANSFER-UPI/CR/487449136601/MS SANJE/KKBK/rahuldixit/Dr Re--,TRANSFER FROM 9137022807,,2353.81,30312.67
29 Sep 2024,TO TRANSFER-UPI/DR/495627070585/ANITA P/ICIC/anitapawar/UPI--,TRANSFER TO 7382910045,3269.16,,27043.51
25 Jul 2024,TO TRANSFER-UPI/DR/440535627468/ANITA P/HDFC/rohit@okhdfc/UPI--,TRANSFER TO 7382910045,934.72,,26108.79
1 Jul 2024,BY TRANSFER-UPI/CR/408407204838/MS SANJE/IDIB/spawar3290/Dr Re--,TRANSFER FROM 4897690162095,,2213.96,28322.75
4 Aug 2024,TO TRANSFER-UPI/DR/407904824624/RAHUL D/SBIN/rohit@okhdfc/UPI--,TRANSFER TO 7382910045,1219.88,,27102.87
22 Sep 2024,BY TRANSFER-UPI/CR/454136983253/RAHUL D/IDIB/rahuldixit/Dr Re--,TRANSFER FROM 8974521398,,3914.77,31017.64
29 Sep 2024,TO TRANSFER-UPI/DR/420013431343/ROHIT T/SBIN/anitapawar/UPI--,TRANSFER TO 9137022807,4853.4,,26164.24
16 Sep 2024,TO TRANSFER-UPI/DR/439576770215/ROHIT T/HDFC/anitapawar/UPI--,TRANSFER TO 4897732162091,4896.06,,21268.18
26 Sep 2024,TO TRANSFER-UPI/DR/450265202679/RAHUL D/SBIN/write2same/UPI--,TRANSFER TO 7382910045,4094.9,,17173.28
6 Aug 2024,BY TRANSFER-UPI/CR/471852790475/SAGAR MO/ICIC/spawar3290/Dr Re--,TRANSFER FROM 7382910045,,4377.99,21551.27
14 Aug 2024,TO TRANSFER-UPI/DR/478926035906/PRIYA K/ICIC/rahuldixit/UPI--,TRANSFER TO 4897690162095,2321.64,,19229.63
30 Sep 2024,TO TRANSFER-UPI/DR/434466497309/SAGAR MO/KKBK/write2same/UPI--,TRANSFER TO 4897732162091,4695.81,,14533.82
20 Sep 2024,TO TRANSFER-UPI/DR/499972930841/RAHUL D/HDFC/rahuldixit/UPI--,TRANSFER TO 9137022807,978.65,,13555.17
15 Jul 2024,TO TRANSFER-UPI/DR/423793336418/ROHIT T/HDFC/rahuldixit/UPI--,TRANSFER TO 4897690162095,4648.57,,8906.6
7 Aug 2024,TO TRANSFER-UPI/DR/433549996233/SAMEER S/ICIC/rohit@okhdfc/UPI--,TRANSFER TO 9137022807,208.91,,8697.69
10 Sep 2024,TO TRANSFER-UPI/DR/429453024655/ROHIT T/HDFC/write2same/UPI--,TRANSFER TO 9137022807,4986.76,,3710.93
24 Sep 2024,TO TRANSFER-UPI/DR/439021475072/MS SANJE/ICIC/spawar3290/UPI--,TRANSFER TO 9137022807,2893.89,,817.04
14 Sep 2024,BY TRANSFER-UPI/CR/489637914708/SAMEER S/SBIN/write2same/Dr Re--,TRANSFER FROM 4897732162091,,3587.9,4404.94
5 Sep 2024,TO TRANSFER-UPI/DR/435692290148/MS SANJE/IDIB/spawar3290/UPI--,TRANSFER TO 9137022807,2964.99,,1439.95
15 Jul 2024,TO TRANSFER-UPI/DR/478765133916/RAHUL D/SBIN/write2same/UPI--,TRANSFER TO 9137022807,453.08,,986.87
2 Aug 2024,TO TRANSFER-UPI/DR/491130807030/MS SANJE/KKBK/anitapawar/UPI--,TRANSFER TO 4897690162095,2286.51,,-1299.64
25 Jul 2024,BY TRANSFER-UPI/CR/427187586064/ROHIT T/SBIN/rohit@okhdfc/Dr Re--,TRANSFER FROM 4897732162091,,1862.39,562.75
15 Jul 2024,TO TRANSFER-UPI/DR/430294331186/SAMEER S/HDFC/spawar3290/UPI--,TRANSFER TO 8974521398,3536.17,,-2973.42
10 Sep 2024,BY TRANSFER-UPI/CR/471095799405/ROHIT T/IDIB/rohit@okhdfc/Dr Re--,TRANSFER FROM 4897690162095,,3829.38,855.96
25 Aug 2024,TO TRANSFER-UPI/DR/403495568740/SAGAR MO/KKBK/anitapawar/UPI--,TRANSFER TO 8974521398,4058.67,,-3202.71
26 Jul 2024,BY TRANSFER-UPI/CR/491513254238/MS SANJE/ICIC/rahuldixit/Dr Re--,TRANSFER FROM 8974521398,,3858.43,655.72
29 Sep 2024,TO TRANSFER-UPI/DR/466397285903/RAHUL D/ICIC/rahuldixit/UPI--,TRANSFER TO 9137022807,2581.51,,-1925.79
18 Jul 2024,TO TRANSFER-UPI/DR/466088642066/SAGAR MO/HDFC/write2same/UPI--,TRANSFER TO 7382910045,297.34,,-2223.13
24 Jul 2024,BY TRANSFER-UPI/CR/436455322883/RAHUL D/ICIC/rahuldixit/Dr Re--,TRANSFER FROM 4897732162091,,1065.89,-1157.24
10 Jul 2024,TO TRANSFER-UPI/DR/471633310463/SAMEER S/HDFC/write2same/UPI--,TRANSFER TO 8974521398,322.45,,-1479.69
1 Jul 2024,BY TRANSFER-UPI/CR/474265202254/ROHIT T/IDIB/write2same/Dr Re--,TRANSFER FROM 4897732162091,,1909.64,429.95
25 Jul 2024,TO TRANSFER-UPI/DR/484266957573/ANITA P/KKBK/write2same/UPI--,TRANSFER TO 4897690162095,3574.88,,-3144.93
27 Aug 2024,BY TRANSFER-UPI/CR/448353366034/MS SANJE/ICIC/anitapawar/Dr Re--,TRANSFER FROM 7382910045,,3761.52,616.59
2 Sep 2024,BY TRANSFER-UPI/CR/478691691707/SAGAR MO/HDFC/anitapawar/Dr Re--,TRANSFER FROM 9137022807,,1846.93,2463.52
11 Aug 2024,BY TRANSFER-UPI/CR/440581722783/SAGAR MO/SBIN/rahuldixit/Dr Re--,TRANSFER FROM 4897732162091,,1611.92,4075.44
28 Jul 2024,BY TRANSFER-UPI/CR/408583461508/SAGAR MO/HDFC/rahuldixit/Dr Re--,TRANSFER FROM 4897732162091,,1597.99,5673.43
15 Aug 2024,TO TRANSFER-UPI/DR/444068461950/MS SANJE/HDFC/anitapawar/UPI--,TRANSFER TO 8974521398,3029.01,,2644.42
22 Aug 2024,BY TRANSFER-UPI/CR/477990007463/ROHIT T/IDIB/anitapawar/Dr Re--,TRANSFER FROM 4897732162091,,4066.88,6711.3
14 Jul 2024,BY TRANSFER-UPI/CR/464903167510/ROHIT T/ICIC/write2same/Dr Re--,TRANSFER FROM 8974521398,,1601.86,8313.16
7 Sep 2024,TO TRANSFER-UPI/DR/403951533675/SAGAR MO/HDFC/anitapawar/UPI--,TRANSFER TO 8974521398,4825.76,,3487.4
24 Sep 2024,BY TRANSFER-UPI/CR/487962869479/SAMEER S/SBIN/anitapawar/Dr Re--,TRANSFER FROM 4897732162091,,2246.39,5733.79
5 Sep 2024,BY TRANSFER-UPI/CR/450964067868/PRIYA K/KKBK/spawar3290/Dr Re--,TRANSFER FROM 4897690162095,,1147.64,6881.43
6 Jul 2024,TO TRANSFER-UPI/DR/465388470638/ANITA P/ICIC/write2same/UPI--,TRANSFER TO 4897690162095,624.49,,6256.94
1 Aug 2024,BY TRANSFER-UPI/CR/496416013728/SAGAR MO/KKBK/spawar3290/Dr Re--,TRANSFER FROM 9137022807,,2032.31,8289.25
11 Sep 2024,BY TRANSFER-UPI/CR/472464754700/MS SANJE/IDIB/anitapawar/Dr Re--,TRANSFER FROM 4897690162095,,1739.3,10028.55
11 Sep 2024,BY TRANSFER-UPI/CR/462058621095/ANITA P/SBIN/write2same/Dr Re--,TRANSFER FROM 4897690162095,,4966.01,14994.56
23 Aug 2024,TO TRANSFER-UPI/DR/447622728492/PRIYA K/ICIC/rohit@okhdfc/UPI--,TRANSFER TO 9137022807,1854.59,,13139.97
16 Aug 2024,BY TRANSFER-UPI/CR/458052756582/ANITA P/SBIN/spawar3290/Dr Re--,TRANSFER FROM 4897732162091,,4385.6,17525.57
14 Jul 2024,BY TRANSFER-UPI/CR/475299372537/ANITA P/HDFC/rohit@okhdfc/Dr Re--,TRANSFER FROM 9137022807,,1249.12,18774.69
7 Aug 2024,BY TRANSFER-UPI/CR/484643768806/PRIYA K/HDFC/anitapawar/Dr Re--,TRANSFER FROM 7382910045,,2256.54,21031.23
12 Sep 2024,TO TRANSFER-UPI/DR/459132199256/MS SANJE/HDFC/write2same/UPI--,TRANSFER TO 7382910045,4781.9,,16249.33
19 Aug 2024,TO TRANSFER-UPI/DR/493001425285/ROHIT T/KKBK/rohit@okhdfc/UPI--,TRANSFER TO 9137022807,2631.2,,13618.13
6 Jul 2024,TO TRANSFER-UPI/DR/488738660601/RAHUL D/KKBK/rahuldixit/UPI--,TRANSFER TO 4897732162091,1337.83,,12280.3
8 Sep 2024,BY TRANSFER-UPI/CR/484628782628/MS SANJE/SBIN/rahuldixit/Dr Re--,TRANSFER FROM 8974521398,,1925.61,14205.91
17 Aug 2024,BY TRANSFER-UPI/CR/470704135788/SAMEER S/ICIC/anitapawar/Dr Re--,TRANSFER FROM 7382910045,,2906.18,17112.09
3 Sep 2024,BY TRANSFER-UPI/CR/405090774148/SAGAR MO/KKBK/rohit@okhdfc/Dr Re--,TRANSFER FROM 7382910045,,2282.72,19394.81
24 Aug 2024,TO TRANSFER-UPI/DR/443805141613/ROHIT T/HDFC/spawar3290/UPI--,TRANSFER TO 4897690162095,2818.1,,16576.71
22 Sep 2024,TO TRANSFER-UPI/DR/448237871963/SAGAR MO/SBIN/rahuldixit/UPI--,TRANSFER TO 4897732162091,1022.18,,15554.53
5 Jul 2024,TO TRANSFER-UPI/DR/460448207111/ROHIT T/HDFC/anitapawar/UPI--,TRANSFER TO 8974521398,3348.37,,12206.16
3 Jul 2024,BY TRANSFER-UPI/CR/475549674808/ANITA P/SBIN/rohit@okhdfc/Dr Re--,TRANSFER FROM 7382910045,,2200.61,14406.77
15 Sep 2024,BY TRANSFER-UPI/CR/420900932268/SAMEER S/KKBK/rohit@okhdfc/Dr Re--,TRANSFER FROM 4897690162095,,4931.01,19337.78
12 Jul 2024,BY TRANSFER-UPI/CR/472965914079/SAMEER S/KKBK/rahuldixit/Dr Re--,TRANSFER FROM 4897690162095,,1608.91,20946.69
27 Jul 2024,BY TRANSFER-UPI/CR/411555461676/SAGAR MO/ICIC/rohit@okhdfc/Dr Re--,TRANSFER FROM 8974521398,,3254.18,24200.87
1 Aug 2024,BY TRANSFER-UPI/CR/499612025635/PRIYA K/KKBK/rahuldixit/Dr Re--,TRANSFER FROM 7382910045,,4243.71,28444.58
14 Aug 2024,BY TRANSFER-UPI/CR/407666972172/MS SANJE/SBIN/write2same/Dr Re--,TRANSFER FROM 4897732162091,,78.73,28523.31
18 Jul 2024,TO TRANSFER-UPI/DR/462196783112/ANITA P/IDIB/write2same/UPI--,TRANSFER TO 9137022807,1500.86,,27022.45
28 Jul 2024,BY TRANSFER-UPI/CR/434375092450/RAHUL D/SBIN/write2same/Dr Re--,TRANSFER FROM 8974521398,,3717.99,30740.44
31 Jul 2024,TO TRANSFER-UPI/DR/474162247426/ANITA P/SBIN/spawar3290/UPI--,TRANSFER TO 4897732162091,2771.73,,27968.71
29 Jul 2024,TO TRANSFER-UPI/DR/477733653180/SAMEER S/SBIN/rahuldixit/UPI--,TRANSFER TO 8974521398,4871.47,,23097.24
7 Jul 2024,BY TRANSFER-UPI/CR/493139130495/SAMEER S/HDFC/rohit@okhdfc/Dr Re--,TRANSFER FROM 8974521398,,2107.44,25204.68
18 Sep 2024,TO TRANSFER-UPI/DR/403823276077/RAHUL D/IDIB/write2same/UPI--,TRANSFER TO 4897732162091,244.94,,24959.74
31 Aug 2024,TO TRANSFER-UPI/DR/406481097928/ANITA P/ICIC/rahuldixit/UPI--,TRANSFER TO 4897690162095,730.34,,24229.4
2 Aug 2024,BY TRANSFER-UPI/CR/431763857217/SAMEER S/SBIN/anitapawar/Dr Re--,TRANSFER FROM 7382910045,,1368.97,25598.37
7 Sep 2024,TO TRANSFER-UPI/DR/444639091028/PRIYA K/HDFC/rohit@okhdfc/UPI--,TRANSFER TO 9137022807,3973.44,,21624.93
6 Jul 2024,BY TRANSFER-UPI/CR/491836369964/SAMEER S/SBIN/rohit@okhdfc/Dr Re--,TRANSFER FROM 8974521398,,3633.96,25258.89
9 Jul 2024,TO TRANSFER-UPI/DR/462575232398/RAHUL D/HDFC/write2same/UPI--,TRANSFER TO 8974521398,172.8,,25086.09
26 Sep 2024,TO TRANSFER-UPI/DR/488213509465/SAGAR MO/ICIC/write2same/UPI--,TRANSFER TO 9137022807,3575.83,,21510.26
13 Jul 2024,BY TRANSFER-UPI/CR/417709485024/ANITA P/SBIN/rahuldixit/Dr Re--,TRANSFER FROM 4897732162091,,4334.78,25845.04
24 Aug 2024,TO TRANSFER-UPI/DR/415443466470/RAHUL D/ICIC/spawar3290/UPI--,TRANSFER TO 7382910045,1647.76,,24197.28
3 Aug 2024,TO TRANSFER-UPI/DR/486560440695/SAMEER S/ICIC/spawar3290/UPI--,TRANSFER TO 9137022807,860.49,,23336.79
12 Aug 2024,BY TRANSFER-UPI/CR/468233492498/ANITA P/KKBK/rahuldixit/Dr Re--,TRANSFER FROM 7382910045,,513.58,23850.37
1 Aug 2024,BY TRANSFER-UPI/CR/402913623561/ROHIT T/SBIN/spawar3290/Dr Re--,TRANSFER FROM 7382910045,,2795.32,26645.69
24 Sep 2024,BY TRANSFER-UPI/CR/405355851852/RAHUL D/ICIC/write2same/Dr Re--,TRANSFER FROM 9137022807,,3375.68,30021.37
28 Aug 2024,TO TRANSFER-UPI/DR/429392355768/RAHUL D/HDFC/rohit@okhdfc/UPI--,TRANSFER TO 8974521398,3849.49,,26171.88
5 Aug 2024,TO TRANSFER-UPI/DR/444121088910/MS SANJE/KKBK/rahuldixit/UPI--,TRANSFER TO 7382910045,3491.22,,22680.66
10 Sep 2024,BY TRANSFER-UPI/CR/407363800412/RAHUL D/ICIC/spawar3290/Dr Re--,TRANSFER FROM 4897690162095,,991.66,23672.32
23 Aug 2024,BY TRANSFER-UPI/CR/455023062945/RAHUL D/KKBK/anitapawar/Dr Re--,TRANSFER FROM 9137022807,,4191.08,27863.4
1 Aug 2024,BY TRANSFER-UPI/CR/427023886451/SAGAR MO/SBIN/anitapawar/Dr Re--,TRANSFER FROM 4897732162091,,4690.13,32553.53
21 Jul 2024,BY TRANSFER-UPI/CR/433461094907/RAHUL D/ICIC/rohit@okhdfc/Dr Re--,TRANSFER FROM 4897690162095,,2610.63,35164.16
11 Aug 2024,BY TRANSFER-UPI/CR/499238307430/MS SANJE/KKBK/spawar3290/Dr Re--,TRANSFER FROM 7382910045,,1157.7,36321.86
21 Aug 2024,BY TRANSFER-UPI/CR/447662467739/MS SANJE/SBIN/write2same/Dr Re--,TRANSFER FROM 4897690162095,,155.08,36476.94
25 Sep 2024,TO TRANSFER-UPI/DR/471994224607/MS SANJE/SBIN/rohit@okhdfc/UPI--,TRANSFER TO 9137022807,514.9,,35962.04
15 Sep 2024,BY TRANSFER-UPI/CR/412197664794/PRIYA K/ICIC/anitapawar/Dr Re--,TRANSFER FROM 4897690162095,,3412.67,39374.71
19 Sep 2024,BY TRANSFER-UPI/CR/463588941943/MS SANJE/ICIC/rohit@okhdfc/Dr Re--,TRANSFER FROM 7382910045,,1304.47,40679.18
14 Jul 2024,TO TRANSFER-UPI/DR/405960279652/PRIYA K/KKBK/rahuldixit/UPI--,TRANSFER TO 4897690162095,1804.91,,38874.27
10 Aug 2024,TO TRANSFER-UPI/DR/444286616751/MS SANJE/HDFC/rahuldixit/UPI--,TRANSFER TO 8974521398,1740.25,,37134.02
29 Aug 2024,TO TRANSFER-UPI/DR/479251005975/RAHUL D/HDFC/rohit@okhdfc/UPI--,TRANSFER TO 7382910045,791.77,,36342.25
19 Aug 2024,BY TRANSFER-UPI/CR/413889911318/RAHUL D/IDIB/rahuldixit/Dr Re--,TRANSFER FROM 8974521398,,2381.19,38723.44
27 Aug 2024,BY TRANSFER-UPI/CR/410463441213/SAGAR MO/KKBK/spawar3290/Dr Re--,TRANSFER FROM 7382910045,,3239.03,41962.47
28 Sep 2024,BY TRANSFER-UPI/CR/439279131963/PRIYA K/KKBK/rohit@okhdfc/Dr Re--,TRANSFER FROM 4897690162095,,2545.61,44508.08
11 Sep 2024,BY TRANSFER-UPI/CR/463705901880/RAHUL D/HDFC/spawar3290/Dr Re--,TRANSFER FROM 8974521398,,3682.73,48190.81
10 Jul 2024,BY TRANSFER-UPI/CR/458875289647/ROHIT T/IDIB/spawar3290/Dr Re--,TRANSFER FROM 8974521398,,811.32,49002.13
3 Sep 2024,BY TRANSFER-UPI/CR/404726649082/SAMEER S/SBIN/rohit@okhdfc/Dr Re--,TRANSFER FROM 9137022807,,4956.91,53959.04
21 Sep 2024,TO TRANSFER-UPI/DR/416891847577/SAMEER S/KKBK/rohit@okhdfc/UPI--,TRANSFER TO 8974521398,563.65,,53395.39
9 Sep 2024,BY TRANSFER-UPI/CR/499739930316/ROHIT T/HDFC/write2same/Dr Re--,TRANSFER FROM 8974521398,,3912.86,57308.25
27 Aug 2024,TO TRANSFER-UPI/DR/476401541846/MS SANJE/KKBK/rohit@okhdfc/UPI--,TRANSFER TO 4897690162095,3089.9,,54218.35
5 Aug 2024,TO TRANSFER-UPI/DR/430255762955/SAMEER S/KKBK/rahuldixit/UPI--,TRANSFER TO 4897732162091,2203.82,,52014.53
5 Jul 2024,BY TRANSFER-UPI/CR/448122628231/SAGAR MO/ICIC/rohit@okhdfc/Dr Re--,TRANSFER FROM 8974521398,,4400.74,56415.27
1 Aug 2024,TO TRANSFER-UPI/DR/446086545371/MS SANJE/SBIN/rohit@okhdfc/UPI--,TRANSFER TO 8974521398,4956.62,,51458.65
14 Sep 2024,BY TRANSFER-UPI/CR/402555932920/ANITA P/SBIN/anitapawar/Dr Re--,TRANSFER FROM 4897732162091,,4225.2,55683.85
1 Jul 2024,TO TRANSFER-UPI/DR/482584104331/ANITA P/SBIN/rahuldixit/UPI--,TRANSFER TO 8974521398,833.97,,54849.88
14 Sep 2024,TO TRANSFER-UPI/DR/476646276026/ROHIT T/HDFC/rahuldixit/UPI--,TRANSFER TO 7382910045,1488.25,,53361.63
14 Sep 2024,BY TRANSFER-UPI/CR/463230399568/ROHIT T/ICIC/anitapawar/Dr Re--,TRANSFER FROM 9137022807,,2569.07,55930.7
16 Aug 2024,BY TRANSFER-UPI/CR/478398335372/PRIYA K/IDIB/anitapawar/Dr Re--,TRANSFER FROM 8974521398,,4487.3,60418.0
23 Aug 2024,BY TRANSFER-UPI/CR/416818232354/SAGAR MO/SBIN/anitapawar/Dr Re--,TRANSFER FROM 9137022807,,3792.68,64210.68
31 Jul 2024,TO TRANSFER-UPI/DR/436692969942/SAMEER S/KKBK/spawar3290/UPI--,TRANSFER TO 4897732162091,705.27,,63505.41
28 Jul 2024,TO TRANSFER-UPI/DR/419970909922/PRIYA K/HDFC/write2same/UPI--,TRANSFER TO 4897732162091,3328.87,,60176.54
13 Sep 2024,TO TRANSFER-UPI/DR/473791841378/ROHIT T/ICIC/rahuldixit/UPI--,TRANSFER TO 7382910045,4773.75,,55402.79
6 Aug 2024,BY TRANSFER-UPI/CR/454066258642/ROHIT T/ICIC/spawar3290/Dr Re--,TRANSFER FROM 8974521398,,4196.29,59599.08
8 Sep 2024,BY TRANSFER-UPI/CR/415741103492/MS SANJE/IDIB/rohit@okhdfc/Dr Re--,TRANSFER FROM 8974521398,,277.18,59876.26
11 Sep 2024,TO TRANSFER-UPI/DR/406122946982/ROHIT T/IDIB/rohit@okhdfc/UPI--,TRANSFER TO 9137022807,3132.73,,56743.53
27 Aug 2024,TO TRANSFER-UPI/DR/474610077286/ROHIT T/KKBK/anitapawar/UPI--,TRANSFER TO 4897690162095,580.0,,56163.53
5 Jul 2024,BY TRANSFER-UPI/CR/461346932875/SAMEER S/SBIN/anitapawar/Dr Re--,TRANSFER FROM 4897690162095,,4266.84,60430.37
17 Jul 2024,TO TRANSFER-UPI/DR/439503893875/ROHIT T/SBIN/write2same/UPI--,TRANSFER TO 4897690162095,3835.64,,56594.73
15 Sep 2024,TO TRANSFER-UPI/DR/441758213110/ROHIT T/KKBK/rahuldixit/UPI--,TRANSFER TO 4897690162095,3632.81,,52961.92
22 Jul 2024,BY TRANSFER-UPI/CR/483073435189/ROHIT T/IDIB/spawar3290/Dr Re--,TRANSFER FROM 8974521398,,878.43,53840.35
2 Aug 2024,BY TRANSFER-UPI/CR/471624036082/SAMEER S/IDIB/anitapawar/Dr Re--,TRANSFER FROM 7382910045,,2839.98,56680.33
6 Aug 2024,TO TRANSFER-UPI/DR/436615533019/RAHUL D/IDIB/rohit@okhdfc/UPI--,TRANSFER TO 4897690162095,1410.53,,55269.8
19 Aug 2024,TO TRANSFER-UPI/DR/488315787509/MS SANJE/SBIN/write2same/UPI--,TRANSFER TO 7382910045,2498.23,,52771.57
9 Sep 2024,BY TRANSFER-UPI/CR/448541549570/ROHIT T/KKBK/anitapawar/Dr Re--,TRANSFER FROM 4897690162095,,2624.8,55396.37
5 Sep 2024,BY TRANSFER-UPI/CR/486930944237/MS SANJE/IDIB/rahuldixit/Dr Re--,TRANSFER FROM 8974521398,,2152.44,57548.81
24 Aug 2024,BY TRANSFER-UPI/CR/408936236059/SAMEER S/SBIN/rahuldixit/Dr Re--,TRANSFER FROM 8974521398,,4729.99,62278.8
7 Jul 2024,TO TRANSFER-UPI/DR/475428918049/ANITA P/HDFC/rohit@okhdfc/UPI--,TRANSFER TO 8974521398,4081.75,,58197.05
27 Sep 2024,BY TRANSFER-UPI/CR/437837192595/MS SANJE/SBIN/rohit@okhdfc/Dr Re--,TRANSFER FROM 4897732162091,,3446.22,61643.27
27 Sep 2024,BY TRANSFER-UPI/CR/433254652189/PRIYA K/ICIC/anitapawar/Dr Re--,TRANSFER FROM 8974521398,,4418.99,66062.26
29 Aug 2024,BY TRANSFER-UPI/CR/433229546987/PRIYA K/ICIC/rohit@okhdfc/Dr Re--,TRANSFER FROM 9137022807,,3563.43,69625.69
9 Sep 2024,BY TRANSFER-UPI/CR/477525886862/RAHUL D/KKBK/anitapawar/Dr Re--,TRANSFER FROM 9137022807,,4419.84,74045.53
21 Jul 2024,TO TRANSFER-UPI/DR/466432866750/PRIYA K/IDIB/rohit@okhdfc/UPI--,TRANSFER TO 8974521398,2288.75,,71756.78
27 Jul 2024,TO TRANSFER-UPI/DR/431012765626/PRIYA K/ICIC/rahuldixit/UPI--,TRANSFER TO 7382910045,4382.86,,67373.92
6 Aug 2024,BY TRANSFER-UPI/CR/467794321599/SAGAR MO/IDIB/write2same/Dr Re--,TRANSFER FROM 7382910045,,2209.65,69583.57
2 Aug 2024,TO TRANSFER-UPI/DR/400445620135/ROHIT T/HDFC/write2same/UPI--,TRANSFER TO 4897690162095,678.99,,68904.58
30 Jul 2024,BY TRANSFER-UPI/CR/418136001724/SAGAR MO/HDFC/spawar3290/Dr Re--,TRANSFER FROM 7382910045,,3752.58,72657.16
7 Aug 2024,TO TRANSFER-UPI/DR/474884767724/SAGAR MO/IDIB/spawar3290/UPI--,TRANSFER TO 4897690162095,4534.89,,68122.27
5 Jul 2024,TO TRANSFER-UPI/DR/436001006859/ROHIT T/SBIN/anitapawar/UPI--,TRANSFER TO 9137022807,4964.53,,63157.74
30 Jul 2024,TO TRANSFER-UPI/DR/469146247614/SAMEER S/SBIN/spawar3290/UPI--,TRANSFER TO 8974521398,1584.93,,61572.81
5 Jul 2024,TO TRANSFER-UPI/DR/438761753565/ANITA P/IDIB/write2same/UPI--,TRANSFER TO 9137022807,3212.04,,58360.77
11 Jul 2024,BY TRANSFER-UPI/CR/425996433757/ROHIT T/ICIC/rohit@okhdfc/Dr Re--,TRANSFER FROM 4897690162095,,940.42,59301.19
13 Sep 2024,BY TRANSFER-UPI/CR/473461837017/ANITA P/IDIB/rahuldixit/Dr Re--,TRANSFER FROM 8974521398,,2936.76,62237.95
7 Jul 2024,BY TRANSFER-UPI/CR/455819033540/SAGAR MO/ICIC/spawar3290/Dr Re--,TRANSFER FROM 7382910045,,3574.68,65812.63
22 Aug 2024,TO TRANSFER-UPI/DR/440245220980/ROHIT T/KKBK/rahuldixit/UPI--,TRANSFER TO 4897690162095,3598.2,,62214.43
22 Aug 2024,TO TRANSFER-UPI/DR/460973319531/PRIYA K/IDIB/anitapawar/UPI--,TRANSFER TO 7382910045,59.09,,62155.34
17 Aug 2024,TO TRANSFER-UPI/DR/494914941358/RAHUL D/ICIC/spawar3290/UPI--,TRANSFER TO 8974521398,1567.58,,60587.76
22 Aug 2024,TO TRANSFER-UPI/DR/483297363959/ANITA P/ICIC/spawar3290/UPI--,TRANSFER TO 7382910045,505.03,,60082.73
13 Jul 2024,BY TRANSFER-UPI/CR/427626188811/SAMEER S/HDFC/rahuldixit/Dr Re--,TRANSFER FROM 9137022807,,2288.59,62371.32
26 Jul 2024,TO TRANSFER-UPI/DR/475960561782/MS SANJE/IDIB/anitapawar/UPI--,TRANSFER TO 8974521398,2567.56,,59803.76
18 Jul 2024,BY TRANSFER-UPI/CR/494228346982/SAGAR MO/KKBK/write2same/Dr Re--,TRANSFER FROM 8974521398,,837.57,60641.33
26 Jul 2024,BY TRANSFER-UPI/CR/434606750813/MS SANJE/SBIN/rohit@okhdfc/Dr Re--,TRANSFER FROM 8974521398,,2395.88,63037.21
17 Aug 2024,TO TRANSFER-UPI/DR/431835998947/SAMEER S/IDIB/spawar3290/UPI--,TRANSFER TO 4897732162091,2447.1,,60590.11
31 Aug 2024,TO TRANSFER-UPI/DR/450022003618/PRIYA K/SBIN/spawar3290/UPI--,TRANSFER TO 4897690162095,2258.34,,58331.77
31 Aug 2024,TO TRANSFER-UPI/DR/499279259348/ROHIT T/ICIC/spawar3290/UPI--,TRANSFER TO 8974521398,2504.04,,55827.73
8 Aug 2024,BY TRANSFER-UPI/CR/450190737243/PRIYA K/HDFC/write2same/Dr Re--,TRANSFER FROM 7382910045,,949.16,56776.89
20 Jul 2024,TO TRANSFER-UPI/DR/478780466140/SAGAR MO/IDIB/anitapawar/UPI--,TRANSFER TO 8974521398,3519.84,,53257.05
4 Aug 2024,BY TRANSFER-UPI/CR/424188370104/SAMEER S/IDIB/write2same/Dr Re--,TRANSFER FROM 9137022807,,2768.58,56025.63
9 Sep 2024,TO TRANSFER-UPI/DR/427029871418/ROHIT T/ICIC/anitapawar/UPI--,TRANSFER TO 8974521398,216.3,,55809.33
28 Aug 2024,TO TRANSFER-UPI/DR/437782498712/RAHUL D/KKBK/write2same/UPI--,TRANSFER TO 4897690162095,939.03,,54870.3
16 Jul 2024,BY TRANSFER-UPI/CR/492255320192/MS SANJE/KKBK/rohit@okhdfc/Dr Re--,TRANSFER FROM 7382910045,,2875.25,57745.55
14 Jul 2024,TO TRANSFER-UPI/DR/407315005533/SAGAR MO/SBIN/spawar3290/UPI--,TRANSFER TO 7382910045,4420.24,,53325.31
21 Aug 2024,BY TRANSFER-UPI/CR/462623321047/MS SANJE/KKBK/write2same/Dr Re--,TRANSFER FROM 9137022807,,1755.42,55080.73
23 Aug 2024,TO TRANSFER-UPI/DR/494763817463/RAHUL D/KKBK/write2same/UPI--,TRANSFER TO 4897690162095,62.53,,55018.2
23 Jul 2024,BY TRANSFER-UPI/CR/454803327347/MS SANJE/HDFC/write2same/Dr Re--,TRANSFER FROM 9137022807,,1806.5,56824.7
9 Aug 2024,BY TRANSFER-UPI/CR/414549444544/ROHIT T/ICIC/spawar3290/Dr Re--,TRANSFER FROM 8974521398,,3504.41,60329.11
28 Aug 2024,BY TRANSFER-UPI/CR/498192626096/SAMEER S/KKBK/rohit@okhdfc/Dr Re--,TRANSFER FROM 8974521398,,950.22,61279.33
24 Jul 2024,BY TRANSFER-UPI/CR/448984697913/ROHIT T/KKBK/rahuldixit/Dr Re--,TRANSFER FROM 4897690162095,,4906.52,66185.85
22 Sep 2024,BY TRANSFER-UPI/CR/452587894723/ROHIT T/KKBK/rahuldixit/Dr Re--,TRANSFER FROM 8974521398,,3624.23,69810.08
18 Aug 2024,TO TRANSFER-UPI/DR/485416610579/ROHIT T/SBIN/anitapawar/UPI--,TRANSFER TO 8974521398,2483.2,,67326.88
25 Jul 2024,TO TRANSFER-UPI/DR/499388829563/ROHIT T/SBIN/anitapawar/UPI--,TRANSFER TO 9137022807,1999.35,,65327.53
7 Sep 2024,TO TRANSFER-UPI/DR/448303456887/RAHUL D/HDFC/anitapawar/UPI--,TRANSFER TO 8974521398,4702.09,,60625.44
13 Aug 2024,BY TRANSFER-UPI/CR/428671807072/MS SANJE/ICIC/spawar3290/Dr Re--,TRANSFER FROM 4897690162095,,1086.41,61711.85
26 Aug 2024,BY TRANSFER-UPI/CR/436798086498/ROHIT T/IDIB/write2same/Dr Re--,TRANSFER FROM 4897690162095,,3664.75,65376.6
17 Jul 2024,BY TRANSFER-UPI/CR/467540482111/SAGAR MO/IDIB/anitapawar/Dr Re--,TRANSFER FROM 4897732162091,,3711.55,69088.15
5 Jul 2024,TO TRANSFER-UPI/DR/457921328592/ANITA P/SBIN/rohit@okhdfc/UPI--,TRANSFER TO 4897732162091,4350.69,,64737.46
19 Jul 2024,BY TRANSFER-UPI/CR/401539164805/ANITA P/IDIB/spawar3290/Dr Re--,TRANSFER FROM 4897732162091,,3434.2,68171.66
23 Sep 2024,TO TRANSFER-UPI/DR/477337992798/MS SANJE/KKBK/rohit@okhdfc/UPI--,TRANSFER TO 4897732162091,3403.92,,64767.74
15 Aug 2024,BY TRANSFER-UPI/CR/485702237690/SAGAR MO/HDFC/anitapawar/Dr Re--,TRANSFER FROM 4897732162091,,1379.51,66147.25
15 Aug 2024,BY TRANSFER-UPI/CR/402464417152/SAMEER S/HDFC/rohit@okhdfc/Dr Re--,TRANSFER FROM 7382910045,,2857.36,69004.61
22 Sep 2024,BY TRANSFER-UPI/CR/413141983598/RAHUL D/IDIB/rahuldixit/Dr Re--,TRANSFER FROM 4897732162091,,603.67,69608.28
18 Jul 2024,TO TRANSFER-UPI/DR/401792162999/RAHUL D/KKBK/rahuldixit/UPI--,TRANSFER TO 9137022807,3579.66,,66028.62
28 Jul 2024,BY TRANSFER-UPI/CR/466208832407/ANITA P/SBIN/spawar3290/Dr Re--,TRANSFER FROM 4897690162095,,2626.52,68655.14
15 Jul 2024,TO TRANSFER-UPI/DR/470150500582/SAMEER S/KKBK/rohit@okhdfc/UPI--,TRANSFER TO 9137022807,4760.53,,63894.61
3 Sep 2024,BY TRANSFER-UPI/CR/499156463712/SAGAR MO/ICIC/spawar3290/Dr Re--,TRANSFER FROM 7382910045,,99.03,63993.64
24 Aug 2024,TO TRANSFER-UPI/DR/410830643788/PRIYA K/ICIC/spawar3290/UPI--,TRANSFER TO 4897732162091,1509.74,,62483.9
15 Sep 2024,BY TRANSFER-UPI/CR/471245938496/MS SANJE/HDFC/rohit@okhdfc/Dr Re--,TRANSFER FROM 4897690162095,,954.76,63438.66
19 Aug 2024,BY TRANSFER-UPI/CR/423137502470/RAHUL D/HDFC/anitapawar/Dr Re--,TRANSFER FROM 4897732162091,,3260.9,66699.56
16 Aug 2024,BY TRANSFER-UPI/CR/487801583775/RAHUL D/SBIN/write2same/Dr Re--,TRANSFER FROM 8974521398,,315.78,67015.34
15 Sep 2024,BY TRANSFER-UPI/CR/498239267048/SAMEER S/KKBK/write2same/Dr Re--,TRANSFER FROM 9137022807,,3032.94,70048.28
1 Jul 2024,TO TRANSFER-UPI/DR/422674521551/MS SANJE/ICIC/anitapawar/UPI--,TRANSFER TO 4897732162091,659.47,,69388.81
11 Jul 2024,TO TRANSFER-UPI/DR/451268834092/SAGAR MO/ICIC/rohit@okhdfc/UPI--,TRANSFER TO 7382910045,313.77,,69075.04
8 Jul 2024,TO TRANSFER-UPI/DR/457748367861/SAGAR MO/HDFC/rohit@okhdfc/UPI--,TRANSFER TO 4897690162095,822.07,,68252.97
28 Sep 2024,BY TRANSFER-UPI/CR/499702553359/ROHIT T/ICIC/write2same/Dr Re--,TRANSFER FROM 7382910045,,1449.56,69702.53
15 Jul 2024,BY TRANSFER-UPI/CR/457213877167/PRIYA K/KKBK/rohit@okhdfc/Dr Re--,TRANSFER FROM 8974521398,,4380.31,74082.84
13 Aug 2024,BY TRANSFER-UPI/CR/402905332833/RAHUL D/SBIN/anitapawar/Dr Re--,TRANSFER FROM 7382910045,,4680.69,78763.53
18 Sep 2024,TO TRANSFER-UPI/DR/416037667238/ANITA P/SBIN/spawar3290/UPI--,TRANSFER TO 9137022807,4748.89,,74014.64
13 Sep 2024,BY TRANSFER-UPI/CR/461296179712/PRIYA K/SBIN/anitapawar/Dr Re--,TRANSFER FROM 4897732162091,,3916.43,77931.07
24 Aug 2024,TO TRANSFER-UPI/DR/468081465471/MS SANJE/IDIB/rohit@okhdfc/UPI--,TRANSFER TO 4897690162095,3366.01,,74565.06
29 Aug 2024,BY TRANSFER-UPI/CR/414901604292/SAGAR MO/IDIB/rohit@okhdfc/Dr Re--,TRANSFER FROM 9137022807,,4296.28,78861.34
18 Sep 2024,BY TRANSFER-UPI/CR/441832026085/SAGAR MO/IDIB/write2same/Dr Re--,TRANSFER FROM 4897732162091,,3228.95,82090.29
20 Aug 2024,TO TRANSFER-UPI/DR/422307607905/PRIYA K/HDFC/spawar3290/UPI--,TRANSFER TO 4897690162095,380.13,,81710.16
15 Jul 2024,TO TRANSFER-UPI/DR/499815747097/MS SANJE/ICIC/rahuldixit/UPI--,TRANSFER TO 9137022807,1077.75,,80632.41
12 Aug 2024,TO TRANSFER-UPI/DR/466009239263/SAMEER S/ICIC/rahuldixit/UPI--,TRANSFER TO 4897690162095,74.83,,80557.58
23 Jul 2024,TO TRANSFER-UPI/DR/436386582822/MS SANJE/HDFC/anitapawar/UPI--,TRANSFER TO 7382910045,4328.16,,76229.42
31 Jul 2024,TO TRANSFER-UPI/DR/439997209298/ROHIT T/SBIN/write2same/UPI--,TRANSFER TO 4897732162091,1517.99,,74711.43
20 Jul 2024,TO TRANSFER-UPI/DR/429172647428/RAHUL D/KKBK/spawar3290/UPI--,TRANSFER TO 8974521398,2820.63,,71890.8
25 Sep 2024,TO TRANSFER-UPI/DR/439047981970/MS SANJE/SBIN/rohit@okhdfc/UPI--,TRANSFER TO 4897690162095,149.59,,71741.21
12 Jul 2024,BY TRANSFER-UPI/CR/429633728191/SAMEER S/SBIN/rahuldixit/Dr Re--,TRANSFER FROM 7382910045,,3270.71,75011.92
30 Aug 2024,TO TRANSFER-UPI/DR/482439534123/ROHIT T/IDIB/spawar3290/UPI--,TRANSFER TO 8974521398,78.39,,74933.53
1 Aug 2024,TO TRANSFER-UPI/DR/442078024986/ANITA P/SBIN/rahuldixit/UPI--,TRANSFER TO 4897690162095,1712.38,,73221.15
17 Sep 2024,BY TRANSFER-UPI/CR/443951012532/SAGAR MO/HDFC/write2same/Dr Re--,TRANSFER FROM 4897732162091,,1436.37,74657.52
22 Jul 2024,TO TRANSFER-UPI/DR/432938396237/PRIYA K/HDFC/rohit@okhdfc/UPI--,TRANSFER TO 8974521398,604.06,,74053.46
6 Aug 2024,BY TRANSFER-UPI/CR/457114402246/PRIYA K/IDIB/write2same/Dr Re--,TRANSFER FROM 9137022807,,4405.84,78459.3
13 Sep 2024,TO TRANSFER-UPI/DR/499706919077/PRIYA K/KKBK/rohit@okhdfc/UPI--,TRANSFER TO 8974521398,2050.93,,76408.37
4 Sep 2024,BY TRANSFER-UPI/CR/435568336529/ROHIT T/IDIB/spawar3290/Dr Re--,TRANSFER FROM 9137022807,,3233.9,79642.27
24 Aug 2024,BY TRANSFER-UPI/CR/405125598341/RAHUL D/HDFC/rohit@okhdfc/Dr Re--,TRANSFER FROM 4897690162095,,3674.26,83316.53
20 Aug 2024,BY TRANSFER-UPI/CR/461791991122/PRIYA K/KKBK/write2same/Dr Re--,TRANSFER FROM 9137022807,,2244.4,85560.93
17 Aug 2024,TO TRANSFER-UPI/DR/472455021507/MS SANJE/KKBK/rahuldixit/UPI--,TRANSFER TO 7382910045,3941.9,,81619.03
3 Sep 2024,BY TRANSFER-UPI/CR/424182131405/RAHUL D/KKBK/rohit@okhdfc/Dr Re--,TRANSFER FROM 4897690162095,,1585.18,83204.21
27 Aug 2024,TO TRANSFER-UPI/DR/453781283230/PRIYA K/KKBK/anitapawar/UPI--,TRANSFER TO 7382910045,4815.43,,78388.78
10 Sep 2024,BY TRANSFER-UPI/CR/472333348113/SAMEER S/KKBK/anitapawar/Dr Re--,TRANSFER FROM 8974521398,,4121.61,82510.39
22 Jul 2024,BY TRANSFER-UPI/CR/462014679418/SAMEER S/SBIN/rohit@okhdfc/Dr Re--,TRANSFER FROM 4897690162095,,3557.4,86067.79
23 Jul 2024,TO TRANSFER-UPI/DR/438151410364/SAMEER S/IDIB/spawar3290/UPI--,TRANSFER TO 8974521398,1923.3,,84144.49
25 Jul 2024,TO TRANSFER-UPI/DR/437518059189/MS SANJE/SBIN/anitapawar/UPI--,TRANSFER TO 4897732162091,2446.29,,81698.2
15 Aug 2024,TO TRANSFER-UPI/DR/447266761621/RAHUL D/ICIC/anitapawar/UPI--,TRANSFER TO 7382910045,2872.66,,78825.54
13 Sep 2024,TO TRANSFER-UPI/DR/427479794143/ANITA P/ICIC/spawar3290/UPI--,TRANSFER TO 9137022807,2591.09,,76234.45
16 Aug 2024,TO TRANSFER-UPI/DR/423737159556/SAMEER S/HDFC/spawar3290/UPI--,TRANSFER TO 9137022807,668.42,,75566.03
18 Sep 2024,BY TRANSFER-UPI/CR/419622926467/ANITA P/KKBK/spawar3290/Dr Re--,TRANSFER FROM 9137022807,,2761.76,78327.79
5 Sep 2024,BY TRANSFER-UPI/CR/481310195564/MS SANJE/HDFC/rahuldixit/Dr Re--,TRANSFER FROM 7382910045,,2576.41,80904.2
14 Sep 2024,TO TRANSFER-UPI/DR/412844269068/RAHUL D/IDIB/rahuldixit/UPI--,TRANSFER TO 4897732162091,4511.07,,76393.13
27 Sep 2024,TO TRANSFER-UPI/DR/425411595459/PRIYA K/SBIN/rohit@okhdfc/UPI--,TRANSFER TO 8974521398,130.15,,76262.98
24 Aug 2024,TO TRANSFER-UPI/DR/490068370333/SAGAR MO/SBIN/write2same/UPI--,TRANSFER TO 9137022807,3169.6,,73093.38
21 Jul 2024,TO TRANSFER-UPI/DR/485041998702/ROHIT T/ICIC/anitapawar/UPI--,TRANSFER TO 9137022807,797.21,,72296.17
27 Sep 2024,BY TRANSFER-UPI/CR/468550853766/SAMEER S/ICIC/rohit@okhdfc/Dr Re--,TRANSFER FROM 8974521398,,1431.11,73727.28
18 Jul 2024,BY TRANSFER-UPI/CR/487641251974/RAHUL D/IDIB/rohit@okhdfc/Dr Re--,TRANSFER FROM 7382910045,,2539.68,76266.96
9 Jul 2024,TO TRANSFER-UPI/DR/492301036446/ANITA P/ICIC/anitapawar/UPI--,TRANSFER TO 9137022807,4509.3,,71757.66
17 Jul 2024,TO TRANSFER-UPI/DR/457317408351/SAGAR MO/HDFC/spawar3290/UPI--,TRANSFER TO 4897732162091,3254.99,,68502.67
24 Sep 2024,BY TRANSFER-UPI/CR/489324081496/SAMEER S/KKBK/rohit@okhdfc/Dr Re--,TRANSFER FROM 9137022807,,4062.99,72565.66
14 Aug 2024,TO TRANSFER-UPI/DR/415593640911/ANITA P/KKBK/spawar3290/UPI--,TRANSFER TO 4897690162095,3910.12,,68655.54
2 Jul 2024,BY TRANSFER-UPI/CR/440661925530/RAHUL D/KKBK/write2same/Dr Re--,TRANSFER FROM 4897690162095,,1340.01,69995.55
23 Aug 2024,TO TRANSFER-UPI/DR/408924867449/MS SANJE/KKBK/rahuldixit/UPI--,TRANSFER TO 8974521398,2734.92,,67260.63
21 Aug 2024,BY TRANSFER-UPI/CR/463832393102/RAHUL D/KKBK/anitapawar/Dr Re--,TRANSFER FROM 4897690162095,,4219.71,71480.34
11 Sep 2024,TO TRANSFER-UPI/DR/433874315170/RAHUL D/SBIN/write2same/UPI--,TRANSFER TO 7382910045,1315.52,,70164.82
18 Aug 2024,TO TRANSFER-UPI/DR/434755815055/PRIYA K/KKBK/anitapawar/UPI--,TRANSFER TO 4897690162095,3912.21,,66252.61
13 Jul 2024,BY TRANSFER-UPI/CR/401492397588/ANITA P/ICIC/rohit@okhdfc/Dr Re--,TRANSFER FROM 9137022807,,4803.27,71055.88
2 Sep 2024,BY TRANSFER-UPI/CR/492038413479/ROHIT T/HDFC/write2same/Dr Re--,TRANSFER FROM 4897690162095,,4813.54,75869.42
23 Aug 2024,BY TRANSFER-UPI/CR/491914851281/ROHIT T/IDIB/spawar3290/Dr Re--,TRANSFER FROM 8974521398,,3099.04,78968.46
17 Sep 2024,TO TRANSFER-UPI/DR/471740441640/ANITA P/ICIC/spawar3290/UPI--,TRANSFER TO 4897732162091,4712.23,,74256.23
13 Aug 2024,TO TRANSFER-UPI/DR/402392614198/ANITA P/HDFC/anitapawar/UPI--,TRANSFER TO 7382910045,3298.46,,70957.77
24 Jul 2024,TO TRANSFER-UPI/DR/479060453331/PRIYA K/HDFC/anitapawar/UPI--,TRANSFER TO 7382910045,4199.45,,66758.32
28 Sep 2024,BY TRANSFER-UPI/CR/418605175508/PRIYA K/IDIB/spawar3290/Dr Re--,TRANSFER FROM 4897690162095,,4499.36,71257.68
6 Aug 2024,TO TRANSFER-UPI/DR/446218649715/ROHIT T/SBIN/rahuldixit/UPI--,TRANSFER TO 8974521398,1634.34,,69623.34
22 Jul 2024,TO TRANSFER-UPI/DR/439708172894/SAGAR MO/SBIN/rohit@okhdfc/UPI--,TRANSFER TO 4897732162091,337.15,,69286.19
28 Jul 2024,TO TRANSFER-UPI/DR/478460776233/ANITA P/SBIN/spawar3290/UPI--,TRANSFER TO 9137022807,2845.76,,66440.43
5 Jul 2024,TO TRANSFER-UPI/DR/422184126931/MS SANJE/HDFC/write2same/UPI--,TRANSFER TO 7382910045,473.11,,65967.32
19 Aug 2024,TO TRANSFER-UPI/DR/412465381992/ROHIT T/SBIN/write2same/UPI--,TRANSFER TO 4897732162091,1531.73,,64435.59
26 Jul 2024,TO TRANSFER-UPI/DR/478396476984/PRIYA K/KKBK/anitapawar/UPI--,TRANSFER TO 4897690162095,461.76,,63973.83
17 Aug 2024,BY TRANSFER-UPI/CR/441193748893/PRIYA K/IDIB/write2same/Dr Re--,TRANSFER FROM 8974521398,,2700.82,66674.65
8 Aug 2024,BY TRANSFER-UPI/CR/432020862439/SAGAR MO/HDFC/spawar3290/Dr Re--,TRANSFER FROM 7382910045,,2214.18,68888.83
14 Sep 2024,TO TRANSFER-UPI/DR/482110350223/PRIYA K/KKBK/rohit@okhdfc/UPI--,TRANSFER TO 4897732162091,1293.88,,67594.95
19 Jul 2024,BY TRANSFER-UPI/CR/423899308548/SAGAR MO/IDIB/write2same/Dr Re--,TRANSFER FROM 4897732162091,,502.52,68097.47
29 Aug 2024,TO TRANSFER-UPI/DR/423327895683/PRIYA K/SBIN/write2same/UPI--,TRANSFER TO 9137022807,4253.64,,63843.83
29 Aug 2024,TO TRANSFER-UPI/DR/442815678429/SAGAR MO/KKBK/rahuldixit/UPI--,TRANSFER TO 9137022807,3768.01,,60075.82
12 Sep 2024,TO TRANSFER-UPI/DR/484544584743/MS SANJE/IDIB/anitapawar/UPI--,TRANSFER TO 7382910045,3514.24,,56561.58
2 Sep 2024,TO TRANSFER-UPI/DR/409198065060/PRIYA K/KKBK/spawar3290/UPI--,TRANSFER TO 4897690162095,3096.12,,53465.46
16 Sep 2024,BY TRANSFER-UPI/CR/484914610896/ROHIT T/IDIB/spawar3290/Dr Re--,TRANSFER FROM 4897732162091,,4285.98,57751.44
7 Jul 2024,TO TRANSFER-UPI/DR/498906518828/ROHIT T/SBIN/rohit@okhdfc/UPI--,TRANSFER TO 9137022807,3847.81,,53903.63
23 Jul 2024,BY TRANSFER-UPI/CR/442723764400/ROHIT T/IDIB/anitapawar/Dr Re--,TRANSFER FROM 7382910045,,4091.63,57995.26
22 Jul 2024,TO TRANSFER-UPI/DR/421858823012/SAGAR MO/SBIN/rahuldixit/UPI--,TRANSFER TO 8974521398,3926.67,,54068.59
15 Sep 2024,TO TRANSFER-UPI/DR/421047918022/MS SANJE/SBIN/anitapawar/UPI--,TRANSFER TO 4897732162091,1479.36,,52589.23
4 Aug 2024,BY TRANSFER-UPI/CR/430298112105/RAHUL D/SBIN/rohit@okhdfc/Dr Re--,TRANSFER FROM 7382910045,,666.32,53255.55
17 Sep 2024,BY TRANSFER-UPI/CR/460480986128/MS SANJE/KKBK/spawar3290/Dr Re--,TRANSFER FROM 8974521398,,2741.6,55997.15
27 Jul 2024,TO TRANSFER-UPI/DR/408567804587/MS SANJE/IDIB/anitapawar/UPI--,TRANSFER TO 7382910045,2602.72,,53394.43
14 Sep 2024,BY TRANSFER-UPI/CR/418969999023/ANITA P/SBIN/rohit@okhdfc/Dr Re--,TRANSFER FROM 4897732162091,,3543.13,56937.56
9 Jul 2024,TO TRANSFER-UPI/DR/435983448168/PRIYA K/HDFC/spawar3290/UPI--,TRANSFER TO 4897690162095,662.58,,56274.98
11 Sep 2024,BY TRANSFER-UPI/CR/443933372060/SAMEER S/IDIB/write2same/Dr Re--,TRANSFER FROM 4897732162091,,2501.51,58776.49
23 Aug 2024,TO TRANSFER-UPI/DR/449654038538/RAHUL D/ICIC/anitapawar/UPI--,TRANSFER TO 4897732162091,4454.14,,54322.35
5 Aug 2024,BY TRANSFER-UPI/CR/431675896800/MS SANJE/IDIB/write2same/Dr Re--,TRANSFER FROM 4897690162095,,852.05,55174.4
22 Sep 2024,BY TRANSFER-UPI/CR/453910162575/SAMEER S/IDIB/anitapawar/Dr Re--,TRANSFER FROM 4897690162095,,3985.16,59159.56
9 Sep 2024,TO TRANSFER-UPI/DR/468243752287/PRIYA K/SBIN/anitapawar/UPI--,TRANSFER TO 9137022807,1914.33,,57245.23
5 Jul 2024,TO TRANSFER-UPI/DR/423784330131/ANITA P/HDFC/anitapawar/UPI--,TRANSFER TO 9137022807,1893.18,,55352.05
18 Jul 2024,TO TRANSFER-UPI/DR/455082093725/SAGAR MO/KKBK/rahuldixit/UPI--,TRANSFER TO 4897690162095,1500.15,,53851.9
10 Aug 2024,BY TRANSFER-UPI/CR/445341035872/ANITA P/IDIB/spawar3290/Dr Re--,TRANSFER FROM 8974521398,,900.47,54752.37
29 Aug 2024,TO TRANSFER-UPI/DR/414179684700/ROHIT T/SBIN/anitapawar/UPI--,TRANSFER TO 4897732162091,1211.43,,53540.94
2 Jul 2024,BY TRANSFER-UPI/CR/456417865620/SAGAR MO/KKBK/rahuldixit/Dr Re--,TRANSFER FROM 7382910045,,3567.51,57108.45
26 Sep 2024,BY TRANSFER-UPI/CR/403851974869/PRIYA K/ICIC/anitapawar/Dr Re--,TRANSFER FROM 4897732162091,,4191.0,61299.45
7 Sep 2024,TO TRANSFER-UPI/DR/499797258784/MS SANJE/ICIC/spawar3290/UPI--,TRANSFER TO 8974521398,3319.6,,57979.85
29 Jul 2024,BY TRANSFER-UPI/CR/421820416748/ROHIT T/SBIN/rahuldixit/Dr Re--,TRANSFER FROM 4897732162091,,3988.1,61967.95
19 Aug 2024,BY TRANSFER-UPI/CR/486372566471/SAGAR MO/ICIC/rohit@okhdfc/Dr Re--,TRANSFER FROM 7382910045,,182.43,62150.38
17 Jul 2024,BY TRANSFER-UPI/CR/404889689302/RAHUL D/ICIC/anitapawar/Dr Re--,TRANSFER FROM 8974521398,,82.23,62232.61
20 Aug 2024,TO TRANSFER-UPI/DR/470708647178/ANITA P/SBIN/anitapawar/UPI--,TRANSFER TO 8974521398,2797.73,,59434.88
10 Jul 2024,BY TRANSFER-UPI/CR/464677188989/ANITA P/HDFC/anitapawar/Dr Re--,TRANSFER FROM 7382910045,,2891.86,62326.74
14 Sep 2024,BY TRANSFER-UPI/CR/434822328844/MS SANJE/SBIN/spawar3290/Dr Re--,TRANSFER FROM 9137022807,,1479.13,63805.87
11 Jul 2024,BY TRANSFER-UPI/CR/445939943420/PRIYA K/HDFC/rahuldixit/Dr Re--,TRANSFER FROM 9137022807,,4236.99,68042.86
24 Sep 2024,BY TRANSFER-UPI/CR/493357331420/ANITA P/KKBK/anitapawar/Dr Re--,TRANSFER FROM 4897690162095,,3154.42,71197.28
25 Aug 2024,TO TRANSFER-UPI/DR/484600428206/ANITA P/ICIC/write2same/UPI--,TRANSFER TO 4897690162095,4615.8,,66581.48
12 Sep 2024,BY TRANSFER-UPI/CR/447325365075/ROHIT T/HDFC/rohit@okhdfc/Dr Re--,TRANSFER FROM 7382910045,,4820.18,71401.66
13 Aug 2024,TO TRANSFER-UPI/DR/463268196919/SAMEER S/HDFC/rohit@okhdfc/UPI--,TRANSFER TO 8974521398,4460.48,,66941.18
5 Aug 2024,TO TRANSFER-UPI/DR/469156370001/RAHUL D/IDIB/write2same/UPI--,TRANSFER TO 4897690162095,615.11,,66326.07
31 Aug 2024,TO TRANSFER-UPI/DR/482349831982/ANITA P/ICIC/rohit@okhdfc/UPI--,TRANSFER TO 4897690162095,644.55,,65681.52
18 Sep 2024,BY TRANSFER-UPI/CR/417472739521/RAHUL D/SBIN/rahuldixit/Dr Re--,TRANSFER FROM 7382910045,,2596.36,68277.88
2 Sep 2024,TO TRANSFER-UPI/DR/407381723941/SAMEER S/KKBK/write2same/UPI--,TRANSFER TO 9137022807,3273.02,,65004.86
14 Jul 2024,TO TRANSFER-UPI/DR/419019923492/SAGAR MO/SBIN/write2same/UPI--,TRANSFER TO 4897732162091,1209.93,,63794.93
17 Jul 2024,BY TRANSFER-UPI/CR/410152723469/SAMEER S/KKBK/anitapawar/Dr Re--,TRANSFER FROM 8974521398,,2292.66,66087.59
18 Jul 2024,TO TRANSFER-UPI/DR/448376686528/ANITA P/IDIB/rahuldixit/UPI--,TRANSFER TO 8974521398,2387.05,,63700.54
22 Jul 2024,TO TRANSFER-UPI/DR/410743005922/ROHIT T/KKBK/write2same/UPI--,TRANSFER TO 7382910045,2903.06,,60797.48
29 Sep 2024,BY TRANSFER-UPI/CR/449734034638/MS SANJE/SBIN/rohit@okhdfc/Dr Re--,TRANSFER FROM 8974521398,,2928.27,63725.75
25 Sep 2024,BY TRANSFER-UPI/CR/417256232206/MS SANJE/KKBK/rahuldixit/Dr Re--,TRANSFER FROM 4897690162095,,4268.28,67994.03
15 Sep 2024,BY TRANSFER-UPI/CR/472970999141/SAGAR MO/IDIB/spawar3290/Dr Re--,TRANSFER FROM 4897732162091,,1374.54,69368.57
10 Aug 2024,TO TRANSFER-UPI/DR/492421738489/ROHIT T/IDIB/rahuldixit/UPI--,TRANSFER TO 4897732162091,2746.57,,66622.0
1 Jul 2024,BY TRANSFER-UPI/CR/421792894451/SAMEER S/ICIC/rahuldixit/Dr Re--,TRANSFER FROM 4897690162095,,1313.35,67935.35
15 Sep 2024,BY TRANSFER-UPI/CR/477838372327/SAGAR MO/ICIC/rahuldixit/Dr Re--,TRANSFER FROM 9137022807,,2048.49,69983.84
13 Jul 2024,TO TRANSFER-UPI/DR/493388219460/ANITA P/SBIN/spawar3290/UPI--,TRANSFER TO 4897732162091,1907.98,,68075.86
16 Jul 2024,BY TRANSFER-UPI/CR/465494154651/SAGAR MO/ICIC/rohit@okhdfc/Dr Re--,TRANSFER FROM 8974521398,,3632.35,71708.21
14 Sep 2024,TO TRANSFER-UPI/DR/468984900033/RAHUL D/ICIC/anitapawar/UPI--,TRANSFER TO 9137022807,4485.66,,67222.55
3 Jul 2024,BY TRANSFER-UPI/CR/452479254557/SAGAR MO/SBIN/rahuldixit/Dr Re--,TRANSFER FROM 8974521398,,1393.43,68615.98
16 Sep 2024,TO TRANSFER-UPI/DR/462774803243/SAGAR MO/IDIB/rohit@okhdfc/UPI--,TRANSFER TO 7382910045,3869.72,,64746.26
1 Jul 2024,TO TRANSFER-UPI/DR/444507052631/SAMEER S/IDIB/rahuldixit/UPI--,TRANSFER TO 8974521398,2455.06,,62291.2
8 Sep 2024,TO TRANSFER-UPI/DR/407035242209/RAHUL D/IDIB/rohit@okhdfc/UPI--,TRANSFER TO 9137022807,3125.9,,59165.3
9 Jul 2024,TO TRANSFER-UPI/DR/434346567896/SAGAR MO/IDIB/spawar3290/UPI--,TRANSFER TO 9137022807,2958.27,,56207.03
3 Jul 2024,TO TRANSFER-UPI/DR/486939728859/SAMEER S/KKBK/anitapawar/UPI--,TRANSFER TO 4897690162095,2086.66,,54120.37
20 Jul 2024,BY TRANSFER-UPI/CR/478427813696/ROHIT T/IDIB/rohit@okhdfc/Dr Re--,TRANSFER FROM 4897690162095,,2036.04,56156.41
2 Aug 2024,TO TRANSFER-UPI/DR/449387985929/ROHIT T/KKBK/anitapawar/UPI--,TRANSFER TO 4897690162095,4993.98,,51162.43
26 Aug 2024,BY TRANSFER-UPI/CR/443113229680/RAHUL D/IDIB/rohit@okhdfc/Dr Re--,TRANSFER FROM 9137022807,,3994.12,55156.55
18 Jul 2024,BY TRANSFER-UPI/CR/406009931140/MS SANJE/KKBK/rahuldixit/Dr Re--,TRANSFER FROM 7382910045,,2392.1,57548.65
4 Jul 2024,TO TRANSFER-UPI/DR/493992062687/ANITA P/HDFC/write2same/UPI--,TRANSFER TO 4897732162091,892.61,,56656.04
22 Sep 2024,BY TRANSFER-UPI/CR/413478821540/MS SANJE/ICIC/rahuldixit/Dr Re--,TRANSFER FROM 7382910045,,3422.69,60078.73
30 Sep 2024,TO TRANSFER-UPI/DR/440119241973/SAGAR MO/HDFC/anitapawar/UPI--,TRANSFER TO 4897690162095,615.16,,59463.57
11 Jul 2024,BY TRANSFER-UPI/CR/477704334894/SAGAR MO/KKBK/spawar3290/Dr Re--,TRANSFER FROM 4897732162091,,3800.03,63263.6
10 Sep 2024,TO TRANSFER-UPI/DR/497431061848/ROHIT T/IDIB/spawar3290/UPI--,TRANSFER TO 4897690162095,4497.39,,58766.21
12 Sep 2024,TO TRANSFER-UPI/DR/447561955923/PRIYA K/ICIC/write2same/UPI--,TRANSFER TO 7382910045,813.75,,57952.46
26 Sep 2024,TO TRANSFER-UPI/DR/427018937698/ROHIT T/IDIB/spawar3290/UPI--,TRANSFER TO 8974521398,3300.72,,54651.74
23 Jul 2024,TO TRANSFER-UPI/DR/437043361248/SAMEER S/SBIN/spawar3290/UPI--,TRANSFER TO 7382910045,1800.94,,52850.8
28 Sep 2024,BY TRANSFER-UPI/CR/406899705694/RAHUL D/IDIB/rohit@okhdfc/Dr Re--,TRANSFER FROM 7382910045,,313.22,53164.02
28 Jul 2024,BY TRANSFER-UPI/CR/495339226942/PRIYA K/KKBK/rahuldixit/Dr Re--,TRANSFER FROM 4897732162091,,1612.9,54776.92
25 Aug 2024,BY TRANSFER-UPI/CR/432869882741/SAGAR MO/SBIN/anitapawar/Dr Re--,TRANSFER FROM 4897690162095,,2125.89,56902.81
10 Jul 2024,TO TRANSFER-UPI/DR/470175301573/PRIYA K/ICIC/write2same/UPI--,TRANSFER TO 8974521398,2281.34,,54621.47
28 Jul 2024,TO TRANSFER-UPI/DR/467373905603/RAHUL D/IDIB/spawar3290/UPI--,TRANSFER TO 8974521398,827.65,,53793.82
19 Aug 2024,TO TRANSFER-UPI/DR/493552404347/RAHUL D/IDIB/rohit@okhdfc/UPI--,TRANSFER TO 7382910045,3973.85,,49819.97
2 Aug 2024,BY TRANSFER-UPI/CR/401539534167/ROHIT T/ICIC/spawar3290/Dr Re--,TRANSFER FROM 9137022807,,3415.07,53235.04
5 Jul 2024,TO TRANSFER-UPI/DR/413177847784/ANITA P/SBIN/write2same/UPI--,TRANSFER TO 8974521398,4210.94,,49024.1
24 Aug 2024,BY TRANSFER-UPI/CR/421223904614/PRIYA K/IDIB/rohit@okhdfc/Dr Re--,TRANSFER FROM 4897690162095,,682.16,49706.26
29 Aug 2024,TO TRANSFER-UPI/DR/417824815608/RAHUL D/HDFC/spawar3290/UPI--,TRANSFER TO 8974521398,2977.33,,46728.93
26 Aug 2024,BY TRANSFER-UPI/CR/474432426904/SAGAR MO/HDFC/spawar3290/Dr Re--,TRANSFER FROM 9137022807,,1759.9,48488.83
10 Aug 2024,BY TRANSFER-UPI/CR/431561008589/RAHUL D/SBIN/write2same/Dr Re--,TRANSFER FROM 4897732162091,,203.99,48692.82
14 Jul 2024,BY TRANSFER-UPI/CR/411314233955/PRIYA K/KKBK/spawar3290/Dr Re--,TRANSFER FROM 7382910045,,3178.82,51871.64
20 Jul 2024,TO TRANSFER-UPI/DR/422196795828/SAMEER S/IDIB/anitapawar/UPI--,TRANSFER TO 4897732162091,2713.69,,49157.95
31 Aug 2024,TO TRANSFER-UPI/DR/492363813897/PRIYA K/IDIB/rahuldixit/UPI--,TRANSFER TO 9137022807,2343.19,,46814.76
2 Sep 2024,BY TRANSFER-UPI/CR/418845603434/SAGAR MO/IDIB/write2same/Dr Re--,TRANSFER FROM 4897690162095,,979.01,47793.77
26 Jul 2024,BY TRANSFER-UPI/CR/409917060181/ROHIT T/IDIB/write2same/Dr Re--,TRANSFER FROM 8974521398,,2829.35,50623.12
2 Aug 2024,TO TRANSFER-UPI/DR/441764049225/SAMEER S/HDFC/spawar3290/UPI--,TRANSFER TO 9137022807,3117.39,,47505.73
12 Sep 2024,TO TRANSFER-UPI/DR/494290866703/PRIYA K/ICIC/write2same/UPI--,TRANSFER TO 4897690162095,3664.29,,43841.44
13 Jul 2024,BY TRANSFER-UPI/CR/446651942933/RAHUL D/SBIN/rahuldixit/Dr Re--,TRANSFER FROM 7382910045,,4809.36,48650.8
31 Jul 2024,TO TRANSFER-UPI/DR/444095824151/PRIYA K/ICIC/rahuldixit/UPI--,TRANSFER TO 9137022807,1097.81,,47552.99
29 Aug 2024,TO TRANSFER-UPI/DR/448390120655/SAMEER S/ICIC/rahuldixit/UPI--,TRANSFER TO 4897690162095,2152.57,,45400.42
6 Jul 2024,BY TRANSFER-UPI/CR/464889414080/RAHUL D/SBIN/write2same/Dr Re--,TRANSFER FROM 9137022807,,476.68,45877.1
20 Jul 2024,BY TRANSFER-UPI/CR/461372419529/RAHUL D/ICIC/rohit@okhdfc/Dr Re--,TRANSFER FROM 9137022807,,4075.28,49952.38
16 Jul 2024,BY TRANSFER-UPI/CR/490964648998/RAHUL D/ICIC/write2same/Dr Re--,TRANSFER FROM 8974521398,,4543.9,54496.28
10 Aug 2024,TO TRANSFER-UPI/DR/475192641766/ROHIT T/HDFC/write2same/UPI--,TRANSFER TO 7382910045,4505.53,,49990.75
15 Sep 2024,BY TRANSFER-UPI/CR/401423365272/ROHIT T/HDFC/spawar3290/Dr Re--,TRANSFER FROM 7382910045,,3600.61,53591.36
5 Sep 2024,TO TRANSFER-UPI/DR/487883651849/SAMEER S/SBIN/spawar3290/UPI--,TRANSFER TO 4897690162095,252.92,,53338.44
9 Jul 2024,TO TRANSFER-UPI/DR/425143913041/ANITA P/ICIC/anitapawar/UPI--,TRANSFER TO 4897690162095,2840.4,,50498.04
3 Sep 2024,BY TRANSFER-UPI/CR/472418032900/MS SANJE/HDFC/rahuldixit/Dr Re--,TRANSFER FROM 9137022807,,2319.19,52817.23
14 Sep 2024,TO TRANSFER-UPI/DR/402954926834/PRIYA K/HDFC/anitapawar/UPI--,TRANSFER TO 4897690162095,3263.48,,49553.75
6 Aug 2024,TO TRANSFER-UPI/DR/411012931301/MS SANJE/SBIN/rohit@okhdfc/UPI--,TRANSFER TO 9137022807,4085.0,,45468.75
31 Aug 2024,BY TRANSFER-UPI/CR/441328952727/RAHUL D/KKBK/rahuldixit/Dr Re--,TRANSFER FROM 7382910045,,2067.64,47536.39
28 Aug 2024,BY TRANSFER-UPI/CR/418638337196/MS SANJE/KKBK/spawar3290/Dr Re--,TRANSFER FROM 4897732162091,,4299.59,51835.98
5 Jul 2024,TO TRANSFER-UPI/DR/455003798002/SAMEER S/HDFC/write2same/UPI--,TRANSFER TO 8974521398,1288.83,,50547.15
8 Jul 2024,BY TRANSFER-UPI/CR/458463901602/ANITA P/ICIC/write2same/Dr Re--,TRANSFER FROM 9137022807,,411.54,50958.69
29 Aug 2024,BY TRANSFER-UPI/CR/466635632797/PRIYA K/SBIN/rahuldixit/Dr Re--,TRANSFER FROM 4897690162095,,125.89,51084.58
20 Aug 2024,TO TRANSFER-UPI/DR/425970090531/SAGAR MO/SBIN/rahuldixit/UPI--,TRANSFER TO 9137022807,4732.75,,46351.83
29 Aug 2024,BY TRANSFER-UPI/CR/435165184097/ROHIT T/HDFC/spawar3290/Dr Re--,TRANSFER FROM 4897732162091,,3599.63,49951.46
31 Aug 2024,BY TRANSFER-UPI/CR/436111524150/SAGAR MO/HDFC/write2same/Dr Re--,TRANSFER FROM 4897690162095,,157.98,50109.44
18 Jul 2024,TO TRANSFER-UPI/DR/403735364182/MS SANJE/KKBK/spawar3290/UPI--,TRANSFER TO 4897690162095,4010.65,,46098.79
17 Jul 2024,TO TRANSFER-UPI/DR/425280975500/RAHUL D/ICIC/spawar3290/UPI--,TRANSFER TO 4897690162095,348.13,,45750.66
15 Jul 2024,TO TRANSFER-UPI/DR/437407661345/RAHUL D/SBIN/anitapawar/UPI--,TRANSFER TO 9137022807,707.77,,45042.89
2 Aug 2024,BY TRANSFER-UPI/CR/491082114256/PRIYA K/SBIN/rahuldixit/Dr Re--,TRANSFER FROM 9137022807,,4635.4,49678.29
25 Aug 2024,BY TRANSFER-UPI/CR/437679460282/PRIYA K/KKBK/anitapawar/Dr Re--,TRANSFER FROM 8974521398,,1068.07,50746.36
26 Jul 2024,TO TRANSFER-UPI/DR/431324126880/ROHIT T/IDIB/anitapawar/UPI--,TRANSFER TO 4897690162095,2339.81,,48406.55
22 Aug 2024,BY TRANSFER-UPI/CR/437988685868/SAMEER S/HDFC/anitapawar/Dr Re--,TRANSFER FROM 4897732162091,,350.64,48757.19
8 Aug 2024,TO TRANSFER-UPI/DR/499453176750/ROHIT T/IDIB/spawar3290/UPI--,TRANSFER TO 9137022807,3002.39,,45754.8
25 Aug 2024,BY TRANSFER-UPI/CR/491708150311/SAMEER S/KKBK/anitapawar/Dr Re--,TRANSFER FROM 4897690162095,,4712.61,50467.41
13 Sep 2024,BY TRANSFER-UPI/CR/419382001778/ROHIT T/ICIC/anitapawar/Dr Re--,TRANSFER FROM 4897732162091,,304.5,50771.91
5 Jul 2024,BY TRANSFER-UPI/CR/464763067816/SAMEER S/HDFC/rahuldixit/Dr Re--,TRANSFER FROM 9137022807,,1887.09,52659.0
17 Jul 2024,BY TRANSFER-UPI/CR/469559987721/PRIYA K/SBIN/rohit@okhdfc/Dr Re--,TRANSFER FROM 7382910045,,166.55,52825.55
15 Aug 2024,TO TRANSFER-UPI/DR/465264004013/ANITA P/ICIC/rohit@okhdfc/UPI--,TRANSFER TO 4897732162091,1388.59,,51436.96
1 Sep 2024,TO TRANSFER-UPI/DR/478457545990/SAGAR MO/KKBK/anitapawar/UPI--,TRANSFER TO 4897732162091,4437.36,,46999.6
29 Aug 2024,BY TRANSFER-UPI/CR/478605995748/RAHUL D/IDIB/rahuldixit/Dr Re--,TRANSFER FROM 7382910045,,872.74,47872.34
6 Jul 2024,TO TRANSFER-UPI/DR/408786695766/ROHIT T/KKBK/spawar3290/UPI--,TRANSFER TO 4897690162095,2182.91,,45689.43
28 Aug 2024,TO TRANSFER-UPI/DR/413594399304/MS SANJE/SBIN/rohit@okhdfc/UPI--,TRANSFER TO 4897732162091,4253.24,,41436.19
18 Sep 2024,TO TRANSFER-UPI/DR/422712112703/SAMEER S/SBIN/anitapawar/UPI--,TRANSFER TO 8974521398,3052.56,,38383.63
27 Jul 2024,BY TRANSFER-UPI/CR/486047117527/SAGAR MO/HDFC/write2same/Dr Re--,TRANSFER FROM 4897690162095,,3841.75,42225.38
8 Sep 2024,TO TRANSFER-UPI/DR/443264818063/MS SANJE/SBIN/anitapawar/UPI--,TRANSFER TO 7382910045,4222.74,,38002.64
30 Jul 2024,BY TRANSFER-UPI/CR/453516628196/RAHUL D/ICIC/write2same/Dr Re--,TRANSFER FROM 7382910045,,3690.18,41692.82
8 Jul 2024,TO TRANSFER-UPI/DR/455757337634/ROHIT T/IDIB/anitapawar/UPI--,TRANSFER TO 9137022807,961.78,,40731.04
28 Sep 2024,TO TRANSFER-UPI/DR/427440951939/MS SANJE/SBIN/rahuldixit/UPI--,TRANSFER TO 9137022807,1059.91,,39671.13
1 Jul 2024,TO TRANSFER-UPI/DR/423196176046/RAHUL D/SBIN/rohit@okhdfc/UPI--,TRANSFER TO 8974521398,3447.87,,36223.26
31 Aug 2024,TO TRANSFER-UPI/DR/466762268227/MS SANJE/SBIN/spawar3290/UPI--,TRANSFER TO 4897732162091,1726.86,,34496.4
21 Sep 2024,TO TRANSFER-UPI/DR/485733215902/ANITA P/HDFC/rahuldixit/UPI--,TRANSFER TO 4897690162095,2475.83,,32020.57
18 Jul 2024,BY TRANSFER-UPI/CR/407498985748/PRIYA K/KKBK/rahuldixit/Dr Re--,TRANSFER FROM 8974521398,,3525.54,35546.11
10 Aug 2024,TO TRANSFER-UPI/DR/469480324254/SAMEER S/IDIB/rahuldixit/UPI--,TRANSFER TO 4897690162095,798.89,,34747.22
3 Sep 2024,BY TRANSFER-UPI/CR/438373361853/ANITA P/ICIC/spawar3290/Dr Re--,TRANSFER FROM 4897690162095,,1928.29,36675.51
6 Sep 2024,BY TRANSFER-UPI/CR/446765507184/ROHIT T/KKBK/anitapawar/Dr Re--,TRANSFER FROM 8974521398,,4784.41,41459.92
2 Sep 2024,TO TRANSFER-UPI/DR/441088612906/SAGAR MO/IDIB/anitapawar/UPI--,TRANSFER TO 4897690162095,4955.64,,36504.28
30 Sep 2024,TO TRANSFER-UPI/DR/479175377135/SAMEER S/KKBK/spawar3290/UPI--,TRANSFER TO 9137022807,1160.62,,35343.66
28 Aug 2024,TO TRANSFER-UPI/DR/464716407786/ANITA P/SBIN/rahuldixit/UPI--,TRANSFER TO 4897732162091,2929.21,,32414.45
17 Jul 2024,BY TRANSFER-UPI/CR/414323475319/RAHUL D/ICIC/spawar3290/Dr Re--,TRANSFER FROM 4897690162095,,3279.88,35694.33
15 Sep 2024,BY TRANSFER-UPI/CR/448942249756/PRIYA K/ICIC/anitapawar/Dr Re--,TRANSFER FROM 4897690162095,,356.27,36050.6
3 Aug 2024,BY TRANSFER-UPI/CR/472256087116/ROHIT T/IDIB/rahuldixit/Dr Re--,TRANSFER FROM 8974521398,,1995.53,38046.13
3 Sep 2024,BY TRANSFER-UPI/CR/416886620459/PRIYA K/KKBK/rahuldixit/Dr Re--,TRANSFER FROM 7382910045,,941.94,38988.07
2 Aug 2024,TO TRANSFER-UPI/DR/446650497072/SAGAR MO/ICIC/spawar3290/UPI--,TRANSFER TO 4897732162091,3145.64,,35842.43
18 Sep 2024,BY TRANSFER-UPI/CR/414482942629/PRIYA K/HDFC/rohit@okhdfc/Dr Re--,TRANSFER FROM 4897732162091,,434.27,36276.7
11 Jul 2024,BY TRANSFER-UPI/CR/405307244853/MS SANJE/IDIB/rohit@okhdfc/Dr Re--,TRANSFER FROM 4897732162091,,1286.91,37563.61
24 Sep 2024,TO TRANSFER-UPI/DR/402026232994/PRIYA K/ICIC/spawar3290/UPI--,TRANSFER TO 4897690162095,1883.51,,35680.1
10 Sep 2024,TO TRANSFER-UPI/DR/488045420188/SAMEER S/KKBK/anitapawar/UPI--,TRANSFER TO 4897732162091,2701.0,,32979.1
26 Aug 2024,BY TRANSFER-UPI/CR/493570505800/PRIYA K/IDIB/spawar3290/Dr Re--,TRANSFER FROM 9137022807,,979.35,33958.45
29 Jul 2024,BY TRANSFER-UPI/CR/449647230182/SAMEER S/ICIC/write2same/Dr Re--,TRANSFER FROM 4897690162095,,2209.07,36167.52
28 Sep 2024,TO TRANSFER-UPI/DR/457032770037/MS SANJE/SBIN/spawar3290/UPI--,TRANSFER TO 8974521398,4921.67,,31245.85
30 Sep 2024,TO TRANSFER-UPI/DR/407324174754/ROHIT T/ICIC/spawar3290/UPI--,TRANSFER TO 4897732162091,2706.1,,28539.75
8 Aug 2024,TO TRANSFER-UPI/DR/465160511020/ANITA P/IDIB/anitapawar/UPI--,TRANSFER TO 8974521398,4408.63,,24131.12
7 Sep 2024,TO TRANSFER-UPI/DR/483794100399/PRIYA K/KKBK/anitapawar/UPI--,TRANSFER TO 4897690162095,1328.19,,22802.93
25 Aug 2024,BY TRANSFER-UPI/CR/448353666718/MS SANJE/KKBK/spawar3290/Dr Re--,TRANSFER FROM 4897690162095,,729.93,23532.86
27 Aug 2024,TO TRANSFER-UPI/DR/490748912731/ROHIT T/ICIC/rahuldixit/UPI--,TRANSFER TO 4897732162091,175.09,,23357.77
23 Aug 2024,TO TRANSFER-UPI/DR/459888469930/ROHIT T/SBIN/anitapawar/UPI--,TRANSFER TO 7382910045,1589.5,,21768.27
30 Aug 2024,TO TRANSFER-UPI/DR/417100805945/PRIYA K/KKBK/rahuldixit/UPI--,TRANSFER TO 8974521398,182.29,,21585.98
7 Sep 2024,TO TRANSFER-UPI/DR/433539793339/SAMEER S/SBIN/write2same/UPI--,TRANSFER TO 7382910045,2256.16,,19329.82
26 Aug 2024,TO TRANSFER-UPI/DR/494046624024/SAMEER S/IDIB/rohit@okhdfc/UPI--,TRANSFER TO 4897732162091,4138.89,,15190.93
11 Aug 2024,TO TRANSFER-UPI/DR/406706482682/SAMEER S/HDFC/rohit@okhdfc/UPI--,TRANSFER TO 7382910045,3732.04,,11458.89
14 Sep 2024,TO TRANSFER-UPI/DR/425900916318/MS SANJE/IDIB/rahuldixit/UPI--,TRANSFER TO 4897732162091,3993.06,,7465.83
31 Aug 2024,BY TRANSFER-UPI/CR/441827158533/RAHUL D/IDIB/rohit@okhdfc/Dr Re--,TRANSFER FROM 8974521398,,485.02,7950.85
31 Aug 2024,TO TRANSFER-UPI/DR/440801719337/MS SANJE/SBIN/rohit@okhdfc/UPI--,TRANSFER TO 7382910045,1473.88,,6476.97
25 Sep 2024,BY TRANSFER-UPI/CR/411210521303/ANITA P/KKBK/spawar3290/Dr Re--,TRANSFER FROM 7382910045,,259.24,6736.21
4 Aug 2024,TO TRANSFER-UPI/DR/425592795794/ANITA P/SBIN/rohit@okhdfc/UPI--,TRANSFER TO 4897690162095,2569.64,,4166.57
16 Aug 2024,BY TRANSFER-UPI/CR/447071787906/SAMEER S/IDIB/anitapawar/Dr Re--,TRANSFER FROM 9137022807,,4670.01,8836.58
9 Aug 2024,BY TRANSFER-UPI/CR/434094942058/ROHIT T/IDIB/spawar3290/Dr Re--,TRANSFER FROM 9137022807,,4751.51,13588.09
4 Sep 2024,TO TRANSFER-UPI/DR/426730250791/SAMEER S/ICIC/spawar3290/UPI--,TRANSFER TO 8974521398,1782.84,,11805.25
12 Sep 2024,TO TRANSFER-UPI/DR/402266083492/MS SANJE/HDFC/rohit@okhdfc/UPI--,TRANSFER TO 4897690162095,4201.37,,7603.88
5 Sep 2024,BY TRANSFER-UPI/CR/441854902064/ANITA P/SBIN/anitapawar/Dr Re--,TRANSFER FROM 8974521398,,227.68,7831.56
29 Aug 2024,TO TRANSFER-UPI/DR/431958910269/SAMEER S/SBIN/anitapawar/UPI--,TRANSFER TO 9137022807,763.14,,7068.42
29 Sep 2024,BY TRANSFER-UPI/CR/438775641134/SAGAR MO/ICIC/write2same/Dr Re--,TRANSFER FROM 8974521398,,662.93,7731.35
9 Jul 2024,BY TRANSFER-UPI/CR/414068999452/RAHUL D/ICIC/anitapawar/Dr Re--,TRANSFER FROM 4897690162095,,4539.29,12270.64
21 Aug 2024,BY TRANSFER-UPI/CR/405281601820/SAMEER S/SBIN/anitapawar/Dr Re--,TRANSFER FROM 4897732162091,,3205.17,15475.81
1 Sep 2024,TO TRANSFER-UPI/DR/435427100238/SAMEER S/HDFC/rohit@okhdfc/UPI--,TRANSFER TO 9137022807,1371.7,,14104.11
15 Aug 2024,BY TRANSFER-UPI/CR/405982342530/SAGAR MO/ICIC/spawar3290/Dr Re--,TRANSFER FROM 8974521398,,248.32,14352.43
14 Aug 2024,BY TRANSFER-UPI/CR/434153017929/SAMEER S/IDIB/spawar3290/Dr Re--,TRANSFER FROM 7382910045,,328.56,14680.99
19 Aug 2024,BY TRANSFER-UPI/CR/496309383625/SAGAR MO/IDIB/write2same/Dr Re--,TRANSFER FROM 4897690162095,,1247.55,15928.54
11 Sep 2024,TO TRANSFER-UPI/DR/492222781435/MS SANJE/ICIC/anitapawar/UPI--,TRANSFER TO 7382910045,1604.35,,14324.19
1 Sep 2024,BY TRANSFER-UPI/CR/470861403779/SAGAR MO/SBIN/anitapawar/Dr Re--,TRANSFER FROM 7382910045,,1801.78,16125.97
20 Sep 2024,BY TRANSFER-UPI/CR/444585857651/SAGAR MO/HDFC/rohit@okhdfc/Dr Re--,TRANSFER FROM 8974521398,,4925.77,21051.74
13 Aug 2024,TO TRANSFER-UPI/DR/457019465331/ANITA P/ICIC/rahuldixit/UPI--,TRANSFER TO 8974521398,1320.86,,19730.88
3 Jul 2024,BY TRANSFER-UPI/CR/438026301785/MS SANJE/SBIN/spawar3290/Dr Re--,TRANSFER FROM 7382910045,,3427.44,23158.32
8 Sep 2024,TO TRANSFER-UPI/DR/457706099054/SAMEER S/HDFC/rahuldixit/UPI--,TRANSFER TO 9137022807,4730.54,,18427.78
8 Aug 2024,TO TRANSFER-UPI/DR/431788194153/SAGAR MO/IDIB/rohit@okhdfc/UPI--,TRANSFER TO 4897690162095,3984.08,,14443.7
16 Jul 2024,TO TRANSFER-UPI/DR/490401234553/SAMEER S/KKBK/spawar3290/UPI--,TRANSFER TO 7382910045,420.3,,14023.4
12 Jul 2024,TO TRANSFER-UPI/DR/401166451050/ROHIT T/SBIN/rahuldixit/UPI--,TRANSFER TO 7382910045,2175.47,,11847.93
19 Jul 2024,BY TRANSFER-UPI/CR/438528279068/ANITA P/IDIB/rahuldixit/Dr Re--,TRANSFER FROM 4897732162091,,1315.9,13163.83
8 Sep 2024,BY TRANSFER-UPI/CR/452274990851/ANITA P/IDIB/anitapawar/Dr Re--,TRANSFER FROM 7382910045,,547.51,13711.34
5 Sep 2024,BY TRANSFER-UPI/CR/448711467229/SAGAR MO/IDIB/rohit@okhdfc/Dr Re--,TRANSFER FROM 9137022807,,4029.23,17740.57
25 Aug 2024,TO TRANSFER-UPI/DR/434335937012/SAGAR MO/SBIN/rahuldixit/UPI--,TRANSFER TO 9137022807,222.77,,17517.8
3 Sep 2024,BY TRANSFER-UPI/CR/477863904307/RAHUL D/ICIC/anitapawar/Dr Re--,TRANSFER FROM 4897732162091,,563.41,18081.21
14 Aug 2024,TO TRANSFER-UPI/DR/438849059646/PRIYA K/ICIC/spawar3290/UPI--,TRANSFER TO 8974521398,1175.61,,16905.6
1 Jul 2024,BY TRANSFER-UPI/CR/498973841696/PRIYA K/ICIC/anitapawar/Dr Re--,TRANSFER FROM 8974521398,,4161.64,21067.24
30 Sep 2024,BY TRANSFER-UPI/CR/473680382659/SAMEER S/SBIN/anitapawar/Dr Re--,TRANSFER FROM 4897690162095,,187.87,21255.11
5 Sep 2024,BY TRANSFER-UPI/CR/478403721752/ANITA P/KKBK/rahuldixit/Dr Re--,TRANSFER FROM 4897732162091,,4991.1,26246.21
25 Jul 2024,TO TRANSFER-UPI/DR/423097594070/RAHUL D/ICIC/anitapawar/UPI--,TRANSFER TO 7382910045,1202.15,,25044.06
14 Sep 2024,BY TRANSFER-UPI/CR/472277494250/ANITA P/ICIC/write2same/Dr Re--,TRANSFER FROM 4897690162095,,2331.13,27375.19
26 Aug 2024,BY TRANSFER-UPI/CR/465721220607/SAGAR MO/ICIC/spawar3290/Dr Re--,TRANSFER FROM 4897732162091,,3765.26,31140.45
5 Jul 2024,BY TRANSFER-UPI/CR/481350280996/SAMEER S/SBIN/rahuldixit/Dr Re--,TRANSFER FROM 4897690162095,,2122.7,33263.15
22 Sep 2024,BY TRANSFER-UPI/CR/483565834463/PRIYA K/KKBK/rahuldixit/Dr Re--,TRANSFER FROM 4897690162095,,1504.7,34767.85
4 Aug 2024,BY TRANSFER-UPI/CR/432213479560/MS SANJE/SBIN/write2same/Dr Re--,TRANSFER FROM 9137022807,,2555.08,37322.93
23 Aug 2024,TO TRANSFER-UPI/DR/402390299346/PRIYA K/HDFC/rahuldixit/UPI--,TRANSFER TO 7382910045,2503.84,,34819.09
1 Jul 2024,TO TRANSFER-UPI/DR/404240399453/SAGAR MO/SBIN/rahuldixit/UPI--,TRANSFER TO 4897690162095,1114.82,,33704.27
22 Jul 2024,TO TRANSFER-UPI/DR/475602493013/SAGAR MO/ICIC/write2same/UPI--,TRANSFER TO 4897690162095,2434.88,,31269.39
7 Sep 2024,TO TRANSFER-UPI/DR/443255122424/SAMEER S/IDIB/rahuldixit/UPI--,TRANSFER TO 4897690162095,2036.24,,29233.15
14 Aug 2024,TO TRANSFER-UPI/DR/453210537535/SAMEER S/SBIN/write2same/UPI--,TRANSFER TO 8974521398,1754.83,,27478.32
2 Aug 2024,BY TRANSFER-UPI/CR/433788696424/ANITA P/ICIC/write2same/Dr Re--,TRANSFER FROM 8974521398,,847.28,28325.6
12 Aug 2024,BY TRANSFER-UPI/CR/450486228377/PRIYA K/KKBK/anitapawar/Dr Re--,TRANSFER FROM 4897732162091,,2444.99,30770.59
9 Sep 2024,TO TRANSFER-UPI/DR/464423637506/SAMEER S/ICIC/anitapawar/UPI--,TRANSFER TO 7382910045,2737.72,,28032.87
12 Jul 2024,BY TRANSFER-UPI/CR/403140586532/SAMEER S/IDIB/rahuldixit/Dr Re--,TRANSFER FROM 8974521398,,206.75,28239.62
26 Aug 2024,TO TRANSFER-UPI/DR/451369682473/ANITA P/SBIN/rohit@okhdfc/UPI--,TRANSFER TO 7382910045,3348.53,,24891.09
27 Sep 2024,TO TRANSFER-UPI/DR/443781617858/SAGAR MO/KKBK/spawar3290/UPI--,TRANSFER TO 7382910045,1542.19,,23348.9
18 Jul 2024,TO TRANSFER-UPI/DR/440557768397/RAHUL D/ICIC/rohit@okhdfc/UPI--,TRANSFER TO 4897732162091,4954.75,,18394.15
26 Jul 2024,TO TRANSFER-UPI/DR/488680613757/PRIYA K/IDIB/anitapawar/UPI--,TRANSFER TO 4897732162091,149.0,,18245.15
6 Sep 2024,TO TRANSFER-UPI/DR/468899897043/ANITA P/HDFC/rahuldixit/UPI--,TRANSFER TO 9137022807,4235.05,,14010.1
10 Sep 2024,TO TRANSFER-UPI/DR/428443044392/SAGAR MO/HDFC/spawar3290/UPI--,TRANSFER TO 8974521398,4597.67,,9412.43
20 Aug 2024,TO TRANSFER-UPI/DR/444506481485/SAMEER S/KKBK/rahuldixit/UPI--,TRANSFER TO 8974521398,2170.96,,7241.47
29 Aug 2024,BY TRANSFER-UPI/CR/490243065583/MS SANJE/IDIB/rahuldixit/Dr Re--,TRANSFER FROM 4897690162095,,4824.2,12065.67
17 Sep 2024,BY TRANSFER-UPI/CR/406310002741/SAGAR MO/IDIB/rohit@okhdfc/Dr Re--,TRANSFER FROM 4897690162095,,770.76,12836.43
20 Aug 2024,BY TRANSFER-UPI/CR/462467111772/ROHIT T/HDFC/anitapawar/Dr Re--,TRANSFER FROM 4897732162091,,2053.43,14889.86
6 Jul 2024,TO TRANSFER-UPI/DR/438615640121/SAGAR MO/ICIC/anitapawar/UPI--,TRANSFER TO 8974521398,4897.15,,9992.71
6 Aug 2024,TO TRANSFER-UPI/DR/435721037820/PRIYA K/SBIN/anitapawar/UPI--,TRANSFER TO 4897690162095,3362.08,,6630.63
29 Aug 2024,TO TRANSFER-UPI/DR/475419944881/PRIYA K/IDIB/write2same/UPI--,TRANSFER TO 9137022807,3197.8,,3432.83
24 Sep 2024,BY TRANSFER-UPI/CR/413806763499/SAMEER S/ICIC/rahuldixit/Dr Re--,TRANSFER FROM 9137022807,,4984.97,8417.8
15 Sep 2024,BY TRANSFER-UPI/CR/481895213707/MS SANJE/HDFC/spawar3290/Dr Re--,TRANSFER FROM 4897732162091,,2784.93,11202.73
29 Jul 2024,TO TRANSFER-UPI/DR/454869216370/SAMEER S/IDIB/anitapawar/UPI--,TRANSFER TO 7382910045,4087.52,,7115.21
19 Jul 2024,TO TRANSFER-UPI/DR/490198675853/MS SANJE/HDFC/rahuldixit/UPI--,TRANSFER TO 4897690162095,4591.86,,2523.35
31 Aug 2024,BY TRANSFER-UPI/CR/465229159278/ANITA P/HDFC/spawar3290/Dr Re--,TRANSFER FROM 9137022807,,1859.33,4382.68
13 Aug 2024,TO TRANSFER-UPI/DR/447364490828/PRIYA K/KKBK/spawar3290/UPI--,TRANSFER TO 7382910045,1020.0,,3362.68
14 Jul 2024,TO TRANSFER-UPI/DR/459534015527/SAMEER S/ICIC/rahuldixit/UPI--,TRANSFER TO 8974521398,4634.86,,-1272.18
5 Jul 2024,BY TRANSFER-UPI/CR/437292466776/PRIYA K/SBIN/write2same/Dr Re--,TRANSFER FROM 4897690162095,,3323.11,2050.93
19 Aug 2024,TO TRANSFER-UPI/DR/437253641120/ROHIT T/SBIN/rahuldixit/UPI--,TRANSFER TO 8974521398,3757.19,,-1706.26
16 Aug 2024,TO TRANSFER-UPI/DR/473455135379/ROHIT T/HDFC/write2same/UPI--,TRANSFER TO 4897690162095,2569.73,,-4275.99
7 Jul 2024,BY TRANSFER-UPI/CR/427485063080/RAHUL D/ICIC/anitapawar/Dr Re--,TRANSFER FROM 9137022807,,2759.01,-1516.98
11 Aug 2024,BY TRANSFER-UPI/CR/407918567954/RAHUL D/KKBK/anitapawar/Dr Re--,TRANSFER FROM 9137022807,,614.38,-902.6
25 Aug 2024,TO TRANSFER-UPI/DR/477106622298/ROHIT T/SBIN/rohit@okhdfc/UPI--,TRANSFER TO 8974521398,578.36,,-1480.96
7 Aug 2024,TO TRANSFER-UPI/DR/441964028817/ROHIT T/IDIB/rohit@okhdfc/UPI--,TRANSFER TO 7382910045,2949.61,,-4430.57
8 Aug 2024,BY TRANSFER-UPI/CR/495097994436/SAGAR MO/SBIN/spawar3290/Dr Re--,TRANSFER FROM 4897690162095,,1325.02,-3105.55
9 Sep 2024,BY TRANSFER-UPI/CR/457401794237/SAMEER S/IDIB/spawar3290/Dr Re--,TRANSFER FROM 9137022807,,693.35,-2412.2
15 Jul 2024,BY TRANSFER-UPI/CR/454123173586/SAGAR MO/IDIB/rohit@okhdfc/Dr Re--,TRANSFER FROM 8974521398,,367.7,-2044.5
2 Jul 2024,BY TRANSFER-UPI/CR/420082812637/SAMEER S/KKBK/write2same/Dr Re--,TRANSFER FROM 9137022807,,4795.42,2750.92
5 Aug 2024,BY TRANSFER-UPI/CR/467750762379/PRIYA K/SBIN/rohit@okhdfc/Dr Re--,TRANSFER FROM 4897690162095,,3390.88,6141.8
7 Sep 2024,BY TRANSFER-UPI/CR/400525963367/PRIYA K/KKBK/rohit@okhdfc/Dr Re--,TRANSFER FROM 9137022807,,1069.19,7210.99
5 Aug 2024,TO TRANSFER-UPI/DR/470668281833/PRIYA K/HDFC/spawar3290/UPI--,TRANSFER TO 8974521398,1883.63,,5327.36
11 Sep 2024,BY TRANSFER-UPI/CR/407684607964/MS SANJE/ICIC/rahuldixit/Dr Re--,TRANSFER FROM 4897732162091,,744.31,6071.67
28 Aug 2024,TO TRANSFER-UPI/DR/491669166432/RAHUL D/SBIN/rohit@okhdfc/UPI--,TRANSFER TO 7382910045,3231.68,,2839.99
23 Aug 2024,TO TRANSFER-UPI/DR/484491553729/PRIYA K/IDIB/anitapawar/UPI--,TRANSFER TO 7382910045,1475.72,,1364.27
15 Sep 2024,BY TRANSFER-UPI/CR/455195553315/RAHUL D/HDFC/write2same/Dr Re--,TRANSFER FROM 9137022807,,4658.29,6022.56
6 Sep 2024,TO TRANSFER-UPI/DR/482633357121/PRIYA K/SBIN/write2same/UPI--,TRANSFER TO 4897690162095,211.13,,5811.43
17 Jul 2024,BY TRANSFER-UPI/CR/497686959115/SAGAR MO/IDIB/rahuldixit/Dr Re--,TRANSFER FROM 9137022807,,51.32,5862.75
27 Aug 2024,TO TRANSFER-UPI/DR/411110910697/SAGAR MO/HDFC/rahuldixit/UPI--,TRANSFER TO 9137022807,1997.89,,3864.86
7 Aug 2024,BY TRANSFER-UPI/CR/480052700303/PRIYA K/KKBK/write2same/Dr Re--,TRANSFER FROM 8974521398,,1855.77,5720.63
22 Sep 2024,BY TRANSFER-UPI/CR/413175529846/PRIYA K/IDIB/write2same/Dr Re--,TRANSFER FROM 7382910045,,773.6,6494.23
17 Sep 2024,BY TRANSFER-UPI/CR/466059441296/RAHUL D/SBIN/rahuldixit/Dr Re--,TRANSFER FROM 9137022807,,4875.53,11369.76
25 Aug 2024,BY TRANSFER-UPI/CR/480261430356/RAHUL D/IDIB/spawar3290/Dr Re--,TRANSFER FROM 9137022807,,2455.7,13825.46
2 Sep 2024,BY TRANSFER-UPI/CR/433762495745/SAMEER S/HDFC/rohit@okhdfc/Dr Re--,TRANSFER FROM 4897732162091,,4072.82,17898.28
12 Aug 2024,BY TRANSFER-UPI/CR/462015143133/PRIYA K/SBIN/rahuldixit/Dr Re--,TRANSFER FROM 7382910045,,241.0,18139.28
12 Jul 2024,TO TRANSFER-UPI/DR/483786886109/PRIYA K/HDFC/write2same/UPI--,TRANSFER TO 4897690162095,3022.71,,15116.57
30 Aug 2024,TO TRANSFER-UPI/DR/476522209241/PRIYA K/IDIB/rohit@okhdfc/UPI--,TRANSFER TO 9137022807,3399.65,,11716.92
23 Aug 2024,BY TRANSFER-UPI/CR/432080481664/PRIYA K/KKBK/anitapawar/Dr Re--,TRANSFER FROM 4897690162095,,2392.63,14109.55
6 Jul 2024,TO TRANSFER-UPI/DR/483747273025/RAHUL D/SBIN/anitapawar/UPI--,TRANSFER TO 4897690162095,236.26,,13873.29
25 Jul 2024,BY TRANSFER-UPI/CR/414871607858/SAGAR MO/HDFC/rahuldixit/Dr Re--,TRANSFER FROM 7382910045,,1115.99,14989.28
14 Sep 2024,TO TRANSFER-UPI/DR/489542406979/RAHUL D/IDIB/write2same/UPI--,TRANSFER TO 4897732162091,2322.14,,12667.14
5 Jul 2024,TO TRANSFER-UPI/DR/405440490980/PRIYA K/SBIN/write2same/UPI--,TRANSFER TO 4897732162091,4278.82,,8388.32
5 Jul 2024,BY TRANSFER-UPI/CR/424352664166/ANITA P/ICIC/anitapawar/Dr Re--,TRANSFER FROM 4897732162091,,4884.65,13272.97
29 Sep 2024,TO TRANSFER-UPI/DR/492334141763/ANITA P/SBIN/write2same/UPI--,TRANSFER TO 8974521398,2661.93,,10611.04
8 Sep 2024,TO TRANSFER-UPI/DR/455568346708/MS SANJE/ICIC/spawar3290/UPI--,TRANSFER TO 8974521398,3375.73,,7235.31
16 Jul 2024,BY TRANSFER-UPI/CR/481348306284/RAHUL D/KKBK/anitapawar/Dr Re--,TRANSFER FROM 8974521398,,1521.1,8756.41
3 Sep 2024,TO TRANSFER-UPI/DR/488051280290/RAHUL D/ICIC/rohit@okhdfc/UPI--,TRANSFER TO 7382910045,1199.1,,7557.31
28 Sep 2024,TO TRANSFER-UPI/DR/475395967367/SAGAR MO/KKBK/spawar3290/UPI--,TRANSFER TO 7382910045,663.72,,6893.59
20 Sep 2024,TO TRANSFER-UPI/DR/446827533198/MS SANJE/ICIC/spawar3290/UPI--,TRANSFER TO 4897732162091,329.48,,6564.11
11 Sep 2024,TO TRANSFER-UPI/DR/441220140808/SAGAR MO/KKBK/spawar3290/UPI--,TRANSFER TO 4897732162091,1115.43,,5448.68
28 Aug 2024,BY TRANSFER-UPI/CR/475125881792/ANITA P/SBIN/write2same/Dr Re--,TRANSFER FROM 7382910045,,4799.61,10248.29
3 Aug 2024,TO TRANSFER-UPI/DR/478077504083/ROHIT T/SBIN/write2same/UPI--,TRANSFER TO 4897732162091,3671.46,,6576.83
11 Jul 2024,TO TRANSFER-UPI/DR/433457140972/ROHIT T/IDIB/anitapawar/UPI--,TRANSFER TO 8974521398,4842.53,,1734.3
11 Aug 2024,BY TRANSFER-UPI/CR/488419654142/SAMEER S/SBIN/spawar3290/Dr Re--,TRANSFER FROM 7382910045,,592.22,2326.52
21 Jul 2024,BY TRANSFER-UPI/CR/411192617833/ROHIT T/KKBK/write2same/Dr Re--,TRANSFER FROM 4897732162091,,1016.35,3342.87
24 Sep 2024,TO TRANSFER-UPI/DR/468797344322/SAMEER S/ICIC/write2same/UPI--,TRANSFER TO 4897732162091,4486.58,,-1143.71
11 Aug 2024,BY TRANSFER-UPI/CR/424875239241/PRIYA K/SBIN/write2same/Dr Re--,TRANSFER FROM 9137022807,,3188.42,2044.71
26 Sep 2024,TO TRANSFER-UPI/DR/468635071423/RAHUL D/SBIN/write2same/UPI--,TRANSFER TO 9137022807,4704.78,,-2660.07
17 Sep 2024,TO TRANSFER-UPI/DR/461977894171/PRIYA K/IDIB/write2same/UPI--,TRANSFER TO 7382910045,1334.19,,-3994.26
9 Jul 2024,TO TRANSFER-UPI/DR/493918710159/SAGAR MO/KKBK/write2same/UPI--,TRANSFER TO 8974521398,4647.14,,-8641.4
26 Jul 2024,TO TRANSFER-UPI/DR/437809518682/SAGAR MO/IDIB/write2same/UPI--,TRANSFER TO 8974521398,334.69,,-8976.09
18 Sep 2024,BY TRANSFER-UPI/CR/488273631053/PRIYA K/KKBK/spawar3290/Dr Re--,TRANSFER FROM 4897690162095,,456.3,-8519.79
1 Sep 2024,BY TRANSFER-UPI/CR/456504644330/RAHUL D/SBIN/write2same/Dr Re--,TRANSFER FROM 9137022807,,722.11,-7797.68
19 Jul 2024,BY TRANSFER-UPI/CR/479412318951/MS SANJE/IDIB/rahuldixit/Dr Re--,TRANSFER FROM 4897732162091,,2685.95,-5111.73
6 Jul 2024,TO TRANSFER-UPI/DR/409124158191/ROHIT T/SBIN/anitapawar/UPI--,TRANSFER TO 4897732162091,2596.81,,-7708.54
19 Sep 2024,TO TRANSFER-UPI/DR/456084321659/SAMEER S/IDIB/write2same/UPI--,TRANSFER TO 9137022807,4015.87,,-11724.41
19 Aug 2024,BY TRANSFER-UPI/CR/443323111833/RAHUL D/SBIN/rahuldixit/Dr Re--,TRANSFER FROM 9137022807,,1097.55,-10626.86
21 Aug 2024,TO TRANSFER-UPI/DR/482409912704/RAHUL D/IDIB/write2same/UPI--,TRANSFER TO 9137022807,1140.77,,-11767.63
2 Aug 2024,BY TRANSFER-UPI/CR/452444866976/SAMEER S/KKBK/anitapawar/Dr Re--,TRANSFER FROM 4897690162095,,1146.85,-10620.78
12 Jul 2024,BY TRANSFER-UPI/CR/489459218051/SAGAR MO/ICIC/spawar3290/Dr Re--,TRANSFER FROM 9137022807,,3528.62,-7092.16
28 Aug 2024,TO TRANSFER-UPI/DR/469813960930/MS SANJE/SBIN/spawar3290/UPI--,TRANSFER TO 4897690162095,1847.44,,-8939.6
9 Sep 2024,TO TRANSFER-UPI/DR/489656916497/RAHUL D/IDIB/spawar3290/UPI--,TRANSFER TO 4897690162095,2770.94,,-11710.54
1 Sep 2024,BY TRANSFER-UPI/CR/451896714609/RAHUL D/KKBK/rahuldixit/Dr Re--,TRANSFER FROM 8974521398,,4333.44,-7377.1
23 Aug 2024,TO TRANSFER-UPI/DR/413910615623/RAHUL D/KKBK/rohit@okhdfc/UPI--,TRANSFER TO 7382910045,3932.65,,-11309.75
15 Sep 2024,TO TRANSFER-UPI/DR/458161883381/MS SANJE/SBIN/write2same/UPI--,TRANSFER TO 9137022807,1634.48,,-12944.23
12 Sep 2024,BY TRANSFER-UPI/CR/407591296422/RAHUL D/ICIC/rahuldixit/Dr Re--,TRANSFER FROM 8974521398,,2466.43,-10477.8
2 Jul 2024,TO TRANSFER-UPI/DR/406736348317/ANITA P/IDIB/rohit@okhdfc/UPI--,TRANSFER TO 8974521398,2334.8,,-12812.6
6 Jul 2024,BY TRANSFER-UPI/CR/471718020330/ROHIT T/ICIC/rahuldixit/Dr Re--,TRANSFER FROM 7382910045,,2216.94,-10595.66
6 Jul 2024,TO TRANSFER-UPI/DR/446509358308/SAMEER S/IDIB/rahuldixit/UPI--,TRANSFER TO 4897732162091,248.93,,-10844.59
2 Jul 2024,BY TRANSFER-UPI/CR/411657097874/MS SANJE/KKBK/rahuldixit/Dr Re--,TRANSFER FROM 4897732162091,,4120.7,-6723.89
28 Aug 2024,TO TRANSFER-UPI/DR/418096275329/ANITA P/KKBK/rohit@okhdfc/UPI--,TRANSFER TO 7382910045,3266.26,,-9990.15
24 Jul 2024,BY TRANSFER-UPI/CR/447521417221/SAMEER S/SBIN/rohit@okhdfc/Dr Re--,TRANSFER FROM 4897690162095,,1955.74,-8034.41
6 Aug 2024,BY TRANSFER-UPI/CR/486551659468/PRIYA K/KKBK/write2same/Dr Re--,TRANSFER FROM 7382910045,,3389.04,-4645.37
22 Sep 2024,BY TRANSFER-UPI/CR/455251691221/PRIYA K/HDFC/rohit@okhdfc/Dr Re--,TRANSFER FROM 8974521398,,4463.37,-182.0
13 Jul 2024,BY TRANSFER-UPI/CR/402420475660/PRIYA K/HDFC/rahuldixit/Dr Re--,TRANSFER FROM 9137022807,,4176.01,3994.01
5 Jul 2024,TO TRANSFER-UPI/DR/431742477654/MS SANJE/ICIC/write2same/UPI--,TRANSFER TO 8974521398,3166.83,,827.18
1 Sep 2024,BY TRANSFER-UPI/CR/424645619095/PRIYA K/IDIB/spawar3290/Dr Re--,TRANSFER FROM 4897732162091,,2968.59,3795.77
5 Jul 2024,BY TRANSFER-UPI/CR/457150987405/PRIYA K/ICIC/rahuldixit/Dr Re--,TRANSFER FROM 4897690162095,,4827.13,8622.9
28 Sep 2024,TO TRANSFER-UPI/DR/410809061721/SAGAR MO/IDIB/rahuldixit/UPI--,TRANSFER TO 9137022807,4791.15,,3831.75
23 Jul 2024,TO TRANSFER-UPI/DR/402776227621/SAMEER S/SBIN/rohit@okhdfc/UPI--,TRANSFER TO 8974521398,3019.06,,812.69
5 Sep 2024,TO TRANSFER-UPI/DR/412711576722/SAGAR MO/HDFC/rohit@okhdfc/UPI--,TRANSFER TO 7382910045,601.78,,210.91
28 Jul 2024,BY TRANSFER-UPI/CR/417853299729/ROHIT T/IDIB/write2same/Dr Re--,TRANSFER FROM 7382910045,,3056.59,3267.5
16 Sep 2024,BY TRANSFER-UPI/CR/428883212256/SAMEER S/SBIN/spawar3290/Dr Re--,TRANSFER FROM 9137022807,,810.38,4077.88
7 Aug 2024,TO TRANSFER-UPI/DR/466860571803/RAHUL D/KKBK/rohit@okhdfc/UPI--,TRANSFER TO 9137022807,84.3,,3993.58
2 Sep 2024,BY TRANSFER-UPI/CR/451854972750/ROHIT T/IDIB/spawar3290/Dr Re--,TRANSFER FROM 8974521398,,1185.7,5179.28
16 Jul 2024,BY TRANSFER-UPI/CR/487741030711/SAMEER S/ICIC/rohit@okhdfc/Dr Re--,TRANSFER FROM 8974521398,,1947.32,7126.6
28 Aug 2024,BY TRANSFER-UPI/CR/484446490215/ROHIT T/KKBK/rahuldixit/Dr Re--,TRANSFER FROM 4897690162095,,1780.71,8907.31
10 Jul 2024,TO TRANSFER-UPI/DR/446591238440/SAMEER S/SBIN/anitapawar/UPI--,TRANSFER TO 4897690162095,2965.13,,5942.18
3 Sep 2024,BY TRANSFER-UPI/CR/419930596183/SAGAR MO/SBIN/spawar3290/Dr Re--,TRANSFER FROM 8974521398,,2164.23,8106.41
21 Jul 2024,TO TRANSFER-UPI/DR/475856900624/SAGAR MO/HDFC/anitapawar/UPI--,TRANSFER TO 4897690162095,1522.04,,6584.37
26 Aug 2024,BY TRANSFER-UPI/CR/426760101736/SAMEER S/HDFC/write2same/Dr Re--,TRANSFER FROM 9137022807,,1520.49,8104.86
29 Jul 2024,BY TRANSFER-UPI/CR/463174208172/ANITA P/IDIB/rohit@okhdfc/Dr Re--,TRANSFER FROM 4897690162095,,3163.47,11268.33
6 Jul 2024,TO TRANSFER-UPI/DR/470014146173/ANITA P/SBIN/anitapawar/UPI--,TRANSFER TO 4897690162095,4355.94,,6912.39
15 Sep 2024,BY TRANSFER-UPI/CR/466078985694/MS SANJE/IDIB/anitapawar/Dr Re--,TRANSFER FROM 8974521398,,4834.44,11746.83
20 Aug 2024,TO TRANSFER-UPI/DR/476698558919/ROHIT T/IDIB/write2same/UPI--,TRANSFER TO 9137022807,3987.88,,7758.95
12 Jul 2024,TO TRANSFER-UPI/DR/437140378539/SAGAR MO/IDIB/write2same/UPI--,TRANSFER TO 9137022807,2797.2,,4961.75
29 Sep 2024,TO TRANSFER-UPI/DR/453579212245/RAHUL D/ICIC/write2same/UPI--,TRANSFER TO 7382910045,2663.6,,2298.15
19 Sep 2024,TO TRANSFER-UPI/DR/437951216161/PRIYA K/SBIN/spawar3290/UPI--,TRANSFER TO 8974521398,3014.3,,-716.15
1 Sep 2024,BY TRANSFER-UPI/CR/477744243958/ANITA P/SBIN/anitapawar/Dr Re--,TRANSFER FROM 4897732162091,,1245.68,529.53
27 Sep 2024,BY TRANSFER-UPI/CR/456180605345/SAGAR MO/HDFC/spawar3290/Dr Re--,TRANSFER FROM 7382910045,,2198.82,2728.35
14 Jul 2024,BY TRANSFER-UPI/CR/417129805881/SAMEER S/HDFC/write2same/Dr Re--,TRANSFER FROM 8974521398,,1923.75,4652.1
21 Aug 2024,TO TRANSFER-UPI/DR/408619842853/MS SANJE/HDFC/write2same/UPI--,TRANSFER TO 9137022807,1017.06,,3635.04
24 Sep 2024,BY TRANSFER-UPI/CR/481082301739/MS SANJE/SBIN/rohit@okhdfc/Dr Re--,TRANSFER FROM 8974521398,,3674.36,7309.4
6 Sep 2024,TO TRANSFER-UPI/DR/477216627509/SAGAR MO/ICIC/rahuldixit/UPI--,TRANSFER TO 7382910045,361.68,,6947.72
6 Jul 2024,BY TRANSFER-UPI/CR/402241187503/MS SANJE/HDFC/rahuldixit/Dr Re--,TRANSFER FROM 8974521398,,3813.12,10760.84
16 Aug 2024,BY TRANSFER-UPI/CR/434884294967/MS SANJE/ICIC/spawar3290/Dr Re--,TRANSFER FROM 8974521398,,1795.47,12556.31
24 Sep 2024,TO TRANSFER-UPI/DR/462024918532/SAMEER S/KKBK/spawar3290/UPI--,TRANSFER TO 9137022807,1628.04,,10928.27
23 Sep 2024,TO TRANSFER-UPI/DR/480061388492/ANITA P/SBIN/write2same/UPI--,TRANSFER TO 7382910045,4581.37,,6346.9
27 Aug 2024,TO TRANSFER-UPI/DR/428903417226/PRIYA K/HDFC/rohit@okhdfc/UPI--,TRANSFER TO 9137022807,2687.79,,3659.11
1 Aug 2024,TO TRANSFER-UPI/DR/458482781293/SAGAR MO/IDIB/rohit@okhdfc/UPI--,TRANSFER TO 4897690162095,3575.42,,83.69
22 Sep 2024,BY TRANSFER-UPI/CR/414240117550/MS SANJE/KKBK/anitapawar/Dr Re--,TRANSFER FROM 8974521398,,369.78,453.47
3 Sep 2024,BY TRANSFER-UPI/CR/420467925649/SAGAR MO/ICIC/anitapawar/Dr Re--,TRANSFER FROM 9137022807,,425.15,878.62
30 Sep 2024,TO TRANSFER-UPI/DR/433877267100/ROHIT T/ICIC/anitapawar/UPI--,TRANSFER TO 7382910045,4583.44,,-3704.82
24 Sep 2024,BY TRANSFER-UPI/CR/498573473088/PRIYA K/HDFC/anitapawar/Dr Re--,TRANSFER FROM 8974521398,,2789.36,-915.46
29 Jul 2024,TO TRANSFER-UPI/DR/484949692953/RAHUL D/SBIN/rahuldixit/UPI--,TRANSFER TO 4897690162095,2613.84,,-3529.3
20 Aug 2024,TO TRANSFER-UPI/DR/409890750223/SAGAR MO/HDFC/write2same/UPI--,TRANSFER TO 9137022807,4070.98,,-7600.28
29 Jul 2024,BY TRANSFER-UPI/CR/416599730421/SAGAR MO/HDFC/rohit@okhdfc/Dr Re--,TRANSFER FROM 7382910045,,303.93,-7296.35
26 Aug 2024,BY TRANSFER-UPI/CR/444536793109/SAMEER S/ICIC/rohit@okhdfc/Dr Re--,TRANSFER FROM 8974521398,,848.84,-6447.51
3 Jul 2024,BY TRANSFER-UPI/CR/420173255093/ROHIT T/SBIN/write2same/Dr Re--,TRANSFER FROM 7382910045,,1602.45,-4845.06
26 Aug 2024,TO TRANSFER-UPI/DR/446585613762/RAHUL D/ICIC/rohit@okhdfc/UPI--,TRANSFER TO 4897732162091,4024.34,,-8869.4
5 Jul 2024,BY TRANSFER-UPI/CR/427457399320/ANITA P/IDIB/rohit@okhdfc/Dr Re--,TRANSFER FROM 9137022807,,4048.85,-4820.55
9 Jul 2024,BY TRANSFER-UPI/CR/413328541084/SAGAR MO/HDFC/rahuldixit/Dr Re--,TRANSFER FROM 4897690162095,,1955.47,-2865.08
9 Aug 2024,TO TRANSFER-UPI/DR/438575372942/SAMEER S/HDFC/rahuldixit/UPI--,TRANSFER TO 4897690162095,4231.99,,-7097.07
11 Jul 2024,BY TRANSFER-UPI/CR/448174153492/RAHUL D/KKBK/anitapawar/Dr Re--,TRANSFER FROM 9137022807,,3495.07,-3602.0
29 Jul 2024,TO TRANSFER-UPI/DR/405460053378/MS SANJE/IDIB/rahuldixit/UPI--,TRANSFER TO 9137022807,943.17,,-4545.17
22 Aug 2024,BY TRANSFER-UPI/CR/442138203181/ANITA P/HDFC/anitapawar/Dr Re--,TRANSFER FROM 4897732162091,,4227.09,-318.08
8 Aug 2024,TO TRANSFER-UPI/DR/425180951932/PRIYA K/IDIB/rohit@okhdfc/UPI--,TRANSFER TO 7382910045,2193.5,,-2511.58
29 Aug 2024,BY TRANSFER-UPI/CR/403588251341/SAMEER S/HDFC/rahuldixit/Dr Re--,TRANSFER FROM 7382910045,,4310.7,1799.12
27 Aug 2024,TO TRANSFER-UPI/DR/481408525200/ANITA P/HDFC/rahuldixit/UPI--,TRANSFER TO 4897732162091,68.71,,1730.41
10 Aug 2024,TO TRANSFER-UPI/DR/489274779311/SAGAR MO/IDIB/write2same/UPI--,TRANSFER TO 7382910045,1348.0,,382.41
2 Sep 2024,TO TRANSFER-UPI/DR/473549322484/ANITA P/SBIN/anitapawar/UPI--,TRANSFER TO 8974521398,3522.59,,-3140.18
10 Jul 2024,BY TRANSFER-UPI/CR/476372178618/ANITA P/HDFC/rahuldixit/Dr Re--,TRANSFER FROM 7382910045,,2322.72,-817.46
26 Jul 2024,TO TRANSFER-UPI/DR/434259675534/ANITA P/ICIC/rohit@okhdfc/UPI--,TRANSFER TO 9137022807,4540.53,,-5357.99
7 Aug 2024,TO TRANSFER-UPI/DR/475693711103/RAHUL D/KKBK/anitapawar/UPI--,TRANSFER TO 8974521398,4003.32,,-9361.31
1 Jul 2024,TO TRANSFER-UPI/DR/438357935256/ANITA P/SBIN/anitapawar/UPI--,TRANSFER TO 4897732162091,3557.41,,-12918.72
23 Sep 2024,BY TRANSFER-UPI/CR/458036295100/ANITA P/IDIB/spawar3290/Dr Re--,TRANSFER FROM 8974521398,,2113.98,-10804.74
30 Aug 2024,BY TRANSFER-UPI/CR/448033966245/MS SANJE/HDFC/anitapawar/Dr Re--,TRANSFER FROM 8974521398,,3989.31,-6815.43
28 Jul 2024,BY TRANSFER-UPI/CR/441394614410/RAHUL D/SBIN/rahuldixit/Dr Re--,TRANSFER FROM 7382910045,,1674.57,-5140.86
4 Aug 2024,TO TRANSFER-UPI/DR/497390984948/SAGAR MO/HDFC/rohit@okhdfc/UPI--,TRANSFER TO 4897732162091,2098.46,,-7239.32
13 Jul 2024,TO TRANSFER-UPI/DR/441851445388/RAHUL D/SBIN/write2same/UPI--,TRANSFER TO 8974521398,4298.62,,-11537.94
30 Aug 2024,BY TRANSFER-UPI/CR/480570038977/SAMEER S/SBIN/anitapawar/Dr Re--,TRANSFER FROM 9137022807,,4714.37,-6823.57
1 Sep 2024,BY TRANSFER-UPI/CR/470212075312/RAHUL D/KKBK/rahuldixit/Dr Re--,TRANSFER FROM 8974521398,,1828.58,-4994.99
27 Aug 2024,BY TRANSFER-UPI/CR/409492840443/ROHIT T/KKBK/spawar3290/Dr Re--,TRANSFER FROM 4897732162091,,1182.67,-3812.32
31 Aug 2024,BY TRANSFER-UPI/CR/437265902202/ROHIT T/ICIC/rahuldixit/Dr Re--,TRANSFER FROM 4897732162091,,3800.42,-11.9
21 Aug 2024,BY TRANSFER-UPI/CR/488375866135/SAGAR MO/HDFC/write2same/Dr Re--,TRANSFER FROM 4897732162091,,1221.3,1209.4
18 Jul 2024,TO TRANSFER-UPI/DR/439797665836/SAMEER S/SBIN/anitapawar/UPI--,TRANSFER TO 4897732162091,3797.82,,-2588.42
17 Sep 2024,BY TRANSFER-UPI/CR/473712921738/PRIYA K/ICIC/spawar3290/Dr Re--,TRANSFER FROM 7382910045,,4031.17,1442.75
13 Jul 2024,TO TRANSFER-UPI/DR/416126139995/MS SANJE/HDFC/rohit@okhdfc/UPI--,TRANSFER TO 8974521398,212.6,,1230.15
13 Jul 2024,BY TRANSFER-UPI/CR/443861799904/PRIYA K/ICIC/rahuldixit/Dr Re--,TRANSFER FROM 8974521398,,154.75,1384.9
8 Jul 2024,TO TRANSFER-UPI/DR/421520323525/SAMEER S/SBIN/rahuldixit/UPI--,TRANSFER TO 4897690162095,2054.7,,-669.8
6 Sep 2024,TO TRANSFER-UPI/DR/425046922160/SAGAR MO/HDFC/rohit@okhdfc/UPI--,TRANSFER TO 7382910045,3824.64,,-4494.44
15 Sep 2024,BY TRANSFER-UPI/CR/429381921246/PRIYA K/KKBK/rohit@okhdfc/Dr Re--,TRANSFER FROM 7382910045,,2615.11,-1879.33
22 Aug 2024,BY TRANSFER-UPI/CR/420015272468/ANITA P/IDIB/rohit@okhdfc/Dr Re--,TRANSFER FROM 4897732162091,,4865.57,2986.24
2 Jul 2024,TO TRANSFER-UPI/DR/409673199849/MS SANJE/KKBK/anitapawar/UPI--,TRANSFER TO 4897732162091,4655.94,,-1669.7
13 Sep 2024,BY TRANSFER-UPI/CR/499229964059/PRIYA K/KKBK/spawar3290/Dr Re--,TRANSFER FROM 4897690162095,,4908.42,3238.72
25 Sep 2024,TO TRANSFER-UPI/DR/481080846841/ROHIT T/KKBK/rahuldixit/UPI--,TRANSFER TO 4897732162091,3221.83,,16.89
28 Sep 2024,BY TRANSFER-UPI/CR/431182504104/PRIYA K/IDIB/rohit@okhdfc/Dr Re--,TRANSFER FROM 8974521398,,2351.97,2368.86
2 Jul 2024,TO TRANSFER-UPI/DR/418117309891/MS SANJE/HDFC/write2same/UPI--,TRANSFER TO 4897732162091,3431.22,,-1062.36
12 Jul 2024,BY TRANSFER-UPI/CR/479742442098/MS SANJE/KKBK/rahuldixit/Dr Re--,TRANSFER FROM 4897690162095,,4555.99,3493.63
2 Aug 2024,TO TRANSFER-UPI/DR/486039102250/SAMEER S/ICIC/anitapawar/UPI--,TRANSFER TO 9137022807,1374.55,,2119.08
6 Aug 2024,TO TRANSFER-UPI/DR/490556798520/RAHUL D/IDIB/rohit@okhdfc/UPI--,TRANSFER TO 4897732162091,1175.25,,943.83
5 Aug 2024,BY TRANSFER-UPI/CR/496857862032/ROHIT T/IDIB/rohit@okhdfc/Dr Re--,TRANSFER FROM 4897732162091,,4067.04,5010.87
6 Jul 2024,BY TRANSFER-UPI/CR/421829233437/SAGAR MO/SBIN/spawar3290/Dr Re--,TRANSFER FROM 7382910045,,1252.97,6263.84
5 Jul 2024,TO TRANSFER-UPI/DR/487320601620/PRIYA K/SBIN/spawar3290/UPI--,TRANSFER TO 4897732162091,1930.25,,4333.59
27 Jul 2024,TO TRANSFER-UPI/DR/423955197229/ANITA P/KKBK/spawar3290/UPI--,TRANSFER TO 4897732162091,3302.33,,1031.26
31 Aug 2024,BY TRANSFER-UPI/CR/447475787922/ROHIT T/ICIC/anitapawar/Dr Re--,TRANSFER FROM 8974521398,,4269.49,5300.75
5 Aug 2024,BY TRANSFER-UPI/CR/468426508550/ANITA P/ICIC/anitapawar/Dr Re--,TRANSFER FROM 9137022807,,295.25,5596.0
26 Sep 2024,BY TRANSFER-UPI/CR/406477058474/ANITA P/HDFC/spawar3290/Dr Re--,TRANSFER FROM 8974521398,,3414.46,9010.46
27 Aug 2024,TO TRANSFER-UPI/DR/461544430977/ANITA P/ICIC/spawar3290/UPI--,TRANSFER TO 8974521398,4857.56,,4152.9
17 Sep 2024,BY TRANSFER-UPI/CR/429876187952/SAMEER S/KKBK/spawar3290/Dr Re--,TRANSFER FROM 4897690162095,,4391.8,8544.7
29 Jul 2024,BY TRANSFER-UPI/CR/494338147114/MS SANJE/SBIN/rahuldixit/Dr Re--,TRANSFER FROM 4897690162095,,1766.15,10310.85
2 Aug 2024,TO TRANSFER-UPI/DR/476859273992/ANITA P/HDFC/anitapawar/UPI--,TRANSFER TO 9137022807,1990.98,,8319.87
17 Sep 2024,TO TRANSFER-UPI/DR/472108753793/ROHIT T/SBIN/rahuldixit/UPI--,TRANSFER TO 9137022807,1483.63,,6836.24
18 Aug 2024,BY TRANSFER-UPI/CR/476476992817/SAMEER S/HDFC/write2same/Dr Re--,TRANSFER FROM 9137022807,,125.22,6961.46
25 Aug 2024,TO TRANSFER-UPI/DR/427932175667/PRIYA K/KKBK/spawar3290/UPI--,TRANSFER TO 8974521398,729.64,,6231.82
9 Sep 2024,BY TRANSFER-UPI/CR/443342444894/SAMEER S/SBIN/rohit@okhdfc/Dr Re--,TRANSFER FROM 9137022807,,4187.85,10419.67
21 Sep 2024,BY TRANSFER-UPI/CR/404699008751/SAMEER S/IDIB/rohit@okhdfc/Dr Re--,TRANSFER FROM 4897690162095,,3992.66,14412.33
17 Aug 2024,TO TRANSFER-UPI/DR/470790021243/ROHIT T/ICIC/anitapawar/UPI--,TRANSFER TO 7382910045,357.68,,14054.65
8 Jul 2024,BY TRANSFER-UPI/CR/422974385991/SAGAR MO/ICIC/rohit@okhdfc/Dr Re--,TRANSFER FROM 8974521398,,2304.76,16359.41
11 Sep 2024,TO TRANSFER-UPI/DR/453051486791/SAMEER S/SBIN/write2same/UPI--,TRANSFER TO 4897732162091,3022.47,,13336.94
8 Aug 2024,BY TRANSFER-UPI/CR/479440749241/SAMEER S/ICIC/write2same/Dr Re--,TRANSFER FROM 7382910045,,456.23,13793.17
31 Jul 2024,BY TRANSFER-UPI/CR/447949019129/SAMEER S/KKBK/anitapawar/Dr Re--,TRANSFER FROM 4897732162091,,3610.57,17403.74
4 Aug 2024,TO TRANSFER-UPI/DR/442832940645/RAHUL D/ICIC/rohit@okhdfc/UPI--,TRANSFER TO 4897732162091,2825.33,,14578.41
13 Sep 2024,BY TRANSFER-UPI/CR/409450602435/MS SANJE/KKBK/write2same/Dr Re--,TRANSFER FROM 8974521398,,4303.89,18882.3
17 Aug 2024,TO TRANSFER-UPI/DR/485174795689/ROHIT T/ICIC/spawar3290/UPI--,TRANSFER TO 8974521398,50.68,,18831.62
25 Jul 2024,TO TRANSFER-UPI/DR/469585957592/ROHIT T/HDFC/spawar3290/UPI--,TRANSFER TO 4897732162091,4316.96,,14514.66
9 Aug 2024,TO TRANSFER-UPI/DR/440112969656/ANITA P/IDIB/spawar3290/UPI--,TRANSFER TO 8974521398,485.69,,14028.97
16 Aug 2024,BY TRANSFER-UPI/CR/415839729078/MS SANJE/ICIC/rahuldixit/Dr Re--,TRANSFER FROM 4897690162095,,3720.02,17748.99
31 Jul 2024,BY TRANSFER-UPI/CR/499237034562/ANITA P/ICIC/write2same/Dr Re--,TRANSFER FROM 4897732162091,,3932.73,21681.72
24 Aug 2024,BY TRANSFER-UPI/CR/451665470397/PRIYA K/ICIC/rahuldixit/Dr Re--,TRANSFER FROM 9137022807,,4786.76,26468.48
5 Aug 2024,BY TRANSFER-UPI/CR/443840016754/PRIYA K/HDFC/anitapawar/Dr Re--,TRANSFER FROM 7382910045,,1495.57,27964.05
16 Sep 2024,BY TRANSFER-UPI/CR/422820167850/SAGAR MO/HDFC/spawar3290/Dr Re--,TRANSFER FROM 7382910045,,3840.18,31804.23
30 Jul 2024,BY TRANSFER-UPI/CR/438482584392/MS SANJE/SBIN/anitapawar/Dr Re--,TRANSFER FROM 7382910045,,3954.34,35758.57
6 Aug 2024,BY TRANSFER-UPI/CR/401280032145/SAMEER S/KKBK/rohit@okhdfc/Dr Re--,TRANSFER FROM 8974521398,,1838.2,37596.77
1 Sep 2024,BY TRANSFER-UPI/CR/453638607093/ROHIT T/KKBK/write2same/Dr Re--,TRANSFER FROM 4897690162095,,2830.19,40426.96
2 Sep 2024,BY TRANSFER-UPI/CR/499091696765/PRIYA K/SBIN/rohit@okhdfc/Dr Re--,TRANSFER FROM 7382910045,,4913.76,45340.72
25 Jul 2024,TO TRANSFER-UPI/DR/435784696570/MS SANJE/HDFC/rohit@okhdfc/UPI--,TRANSFER TO 7382910045,1696.43,,43644.29
3 Aug 2024,TO TRANSFER-UPI/DR/485654122668/ANITA P/HDFC/write2same/UPI--,TRANSFER TO 4897732162091,2864.33,,40779.96
27 Aug 2024,BY TRANSFER-UPI/CR/423466169499/RAHUL D/IDIB/rohit@okhdfc/Dr Re--,TRANSFER FROM 4897732162091,,3972.45,44752.41
9 Aug 2024,TO TRANSFER-UPI/DR/495570028852/SAMEER S/HDFC/anitapawar/UPI--,TRANSFER TO 8974521398,2501.17,,42251.24
17 Jul 2024,BY TRANSFER-UPI/CR/464400366816/SAGAR MO/HDFC/anitapawar/Dr Re--,TRANSFER FROM 9137022807,,1307.47,43558.71
23 Jul 2024,TO TRANSFER-UPI/DR/451177624478/SAMEER S/IDIB/rahuldixit/UPI--,TRANSFER TO 4897690162095,1111.32,,42447.39
28 Aug 2024,BY TRANSFER-UPI/CR/445918629120/MS SANJE/SBIN/spawar3290/Dr Re--,TRANSFER FROM 9137022807,,2192.18,44639.57
18 Sep 2024,TO TRANSFER-UPI/DR/417119036483/ROHIT T/HDFC/spawar3290/UPI--,TRANSFER TO 4897690162095,4734.46,,39905.11
11 Jul 2024,BY TRANSFER-UPI/CR/422537722742/SAMEER S/SBIN/rohit@okhdfc/Dr Re--,TRANSFER FROM 4897690162095,,4970.56,44875.67
6 Aug 2024,BY TRANSFER-UPI/CR/497601941723/ANITA P/IDIB/rahuldixit/Dr Re--,TRANSFER FROM 7382910045,,1075.24,45950.91
19 Aug 2024,BY TRANSFER-UPI/CR/430570016400/MS SANJE/ICIC/rahuldixit/Dr Re--,TRANSFER FROM 8974521398,,2985.02,48935.93
12 Jul 2024,TO TRANSFER-UPI/DR/440476314147/PRIYA K/HDFC/rahuldixit/UPI--,TRANSFER TO 7382910045,91.41,,48844.52
10 Sep 2024,TO TRANSFER-UPI/DR/488980440890/PRIYA K/SBIN/anitapawar/UPI--,TRANSFER TO 4897732162091,1789.1,,47055.42
6 Sep 2024,TO TRANSFER-UPI/DR/459298316573/SAGAR MO/KKBK/spawar3290/UPI--,TRANSFER TO 4897732162091,3967.66,,43087.76
17 Sep 2024,BY TRANSFER-UPI/CR/462053609349/RAHUL D/HDFC/rohit@okhdfc/Dr Re--,TRANSFER FROM 7382910045,,3978.99,47066.75
3 Jul 2024,TO TRANSFER-UPI/DR/494526072292/SAMEER S/HDFC/anitapawar/UPI--,TRANSFER TO 8974521398,232.77,,46833.98
31 Jul 2024,BY TRANSFER-UPI/CR/474853121672/ROHIT T/KKBK/anitapawar/Dr Re--,TRANSFER FROM 4897690162095,,605.98,47439.96
6 Aug 2024,TO TRANSFER-UPI/DR/445429134935/ROHIT T/HDFC/write2same/UPI--,TRANSFER TO 7382910045,613.7,,46826.26
13 Jul 2024,TO TRANSFER-UPI/DR/472230125027/SAMEER S/HDFC/spawar3290/UPI--,TRANSFER TO 9137022807,4419.95,,42406.31
20 Jul 2024,TO TRANSFER-UPI/DR/439101148855/PRIYA K/HDFC/rahuldixit/UPI--,TRANSFER TO 4897732162091,3894.9,,38511.41
14 Jul 2024,TO TRANSFER-UPI/DR/432893584084/SAGAR MO/ICIC/rohit@okhdfc/UPI--,TRANSFER TO 4897690162095,4275.7,,34235.71
29 Jul 2024,BY TRANSFER-UPI/CR/424197939744/RAHUL D/SBIN/write2same/Dr Re--,TRANSFER FROM 8974521398,,3348.73,37584.44
7 Aug 2024,TO TRANSFER-UPI/DR/431297622174/SAGAR MO/KKBK/rahuldixit/UPI--,TRANSFER TO 4897732162091,4980.12,,32604.32
26 Aug 2024,TO TRANSFER-UPI/DR/403151343334/ANITA P/IDIB/rahuldixit/UPI--,TRANSFER TO 4897690162095,2173.09,,30431.23
7 Aug 2024,BY TRANSFER-UPI/CR/494026490558/SAGAR MO/IDIB/rahuldixit/Dr Re--,TRANSFER FROM 4897690162095,,3633.36,34064.59
19 Sep 2024,TO TRANSFER-UPI/DR/453927917036/ANITA P/KKBK/spawar3290/UPI--,TRANSFER TO 8974521398,1684.81,,32379.78
29 Sep 2024,TO TRANSFER-UPI/DR/499284040234/PRIYA K/ICIC/anitapawar/UPI--,TRANSFER TO 4897732162091,422.59,,31957.19
26 Jul 2024,BY TRANSFER-UPI/CR/417501679192/MS SANJE/KKBK/rohit@okhdfc/Dr Re--,TRANSFER FROM 4897690162095,,731.38,32688.57
21 Aug 2024,BY TRANSFER-UPI/CR/423192782718/MS SANJE/HDFC/spawar3290/Dr Re--,TRANSFER FROM 9137022807,,2757.23,35445.8
14 Aug 2024,TO TRANSFER-UPI/DR/409382676304/MS SANJE/IDIB/anitapawar/UPI--,TRANSFER TO 4897732162091,2498.59,,32947.21
5 Sep 2024,BY TRANSFER-UPI/CR/456708822388/SAMEER S/ICIC/spawar3290/Dr Re--,TRANSFER FROM 9137022807,,4696.4,37643.61
2 Sep 2024,TO TRANSFER-UPI/DR/439218885210/SAGAR MO/SBIN/write2same/UPI--,TRANSFER TO 8974521398,1170.67,,36472.94
20 Sep 2024,TO TRANSFER-UPI/DR/481584118691/ROHIT T/SBIN/spawar3290/UPI--,TRANSFER TO 4897690162095,114.79,,36358.15
31 Jul 2024,BY TRANSFER-UPI/CR/445959908287/MS SANJE/KKBK/spawar3290/Dr Re--,TRANSFER FROM 9137022807,,2889.51,39247.66
28 Sep 2024,TO TRANSFER-UPI/DR/418295188965/ANITA P/SBIN/spawar3290/UPI--,TRANSFER TO 8974521398,2898.1,,36349.56
19 Jul 2024,TO TRANSFER-UPI/DR/490526921554/SAMEER S/SBIN/spawar3290/UPI--,TRANSFER TO 4897690162095,1634.04,,34715.52
9 Aug 2024,TO TRANSFER-UPI/DR/460653296733/ROHIT T/IDIB/rohit@okhdfc/UPI--,TRANSFER TO 7382910045,3055.93,,31659.59
11 Sep 2024,BY TRANSFER-UPI/CR/452876921110/ROHIT T/SBIN/write2same/Dr Re--,TRANSFER FROM 7382910045,,3369.05,35028.64
14 Aug 2024,BY TRANSFER-UPI/CR/434702077320/RAHUL D/IDIB/write2same/Dr Re--,TRANSFER FROM 4897732162091,,2053.0,37081.64
21 Aug 2024,BY TRANSFER-UPI/CR/413449070611/SAMEER S/IDIB/rohit@okhdfc/Dr Re--,TRANSFER FROM 8974521398,,1442.79,38524.43
19 Sep 2024,TO TRANSFER-UPI/DR/418434660065/SAGAR MO/KKBK/spawar3290/UPI--,TRANSFER TO 4897732162091,787.71,,37736.72
4 Aug 2024,TO TRANSFER-UPI/DR/442225619823/PRIYA K/HDFC/anitapawar/UPI--,TRANSFER TO 4897732162091,2848.11,,34888.61
7 Sep 2024,BY TRANSFER-UPI/CR/417883524931/PRIYA K/KKBK/spawar3290/Dr Re--,TRANSFER FROM 9137022807,,1127.89,36016.5
21 Aug 2024,TO TRANSFER-UPI/DR/483792313328/SAGAR MO/ICIC/anitapawar/UPI--,TRANSFER TO 9137022807,626.17,,35390.33
12 Sep 2024,TO TRANSFER-UPI/DR/487707985523/RAHUL D/HDFC/rahuldixit/UPI--,TRANSFER TO 7382910045,585.78,,34804.55
5 Aug 2024,BY TRANSFER-UPI/CR/408874215241/SAGAR MO/KKBK/rohit@okhdfc/Dr Re--,TRANSFER FROM 9137022807,,4019.89,38824.44
20 Sep 2024,BY TRANSFER-UPI/CR/424641509444/MS SANJE/IDIB/spawar3290/Dr Re--,TRANSFER FROM 9137022807,,4501.62,43326.06
31 Jul 2024,TO TRANSFER-UPI/DR/486039296328/ROHIT T/HDFC/rohit@okhdfc/UPI--,TRANSFER TO 8974521398,4002.46,,39323.6
29 Jul 2024,BY TRANSFER-UPI/CR/487088434879/ANITA P/ICIC/write2same/Dr Re--,TRANSFER FROM 9137022807,,2435.88,41759.48
10 Sep 2024,BY TRANSFER-UPI/CR/437934110669/RAHUL D/KKBK/rohit@okhdfc/Dr Re--,TRANSFER FROM 4897732162091,,3571.88,45331.36
3 Aug 2024,BY TRANSFER-UPI/CR/462078233528/SAMEER S/ICIC/anitapawar/Dr Re--,TRANSFER FROM 8974521398,,2982.09,48313.45
25 Jul 2024,BY TRANSFER-UPI/CR/476945571733/SAMEER S/ICIC/rahuldixit/Dr Re--,TRANSFER FROM 4897690162095,,477.96,48791.41
18 Jul 2024,BY TRANSFER-UPI/CR/419505134619/MS SANJE/SBIN/spawar3290/Dr Re--,TRANSFER FROM 4897690162095,,2353.98,51145.39
22 Sep 2024,TO TRANSFER-UPI/DR/452545345946/SAMEER S/KKBK/anitapawar/UPI--,TRANSFER TO 4897690162095,3942.13,,47203.26
17 Jul 2024,TO TRANSFER-UPI/DR/433067956580/SAGAR MO/SBIN/rahuldixit/UPI--,TRANSFER TO 9137022807,1466.89,,45736.37
24 Sep 2024,TO TRANSFER-UPI/DR/447190553499/PRIYA K/ICIC/spawar3290/UPI--,TRANSFER TO 8974521398,2904.49,,42831.88
12 Jul 2024,TO TRANSFER-UPI/DR/494908224489/PRIYA K/HDFC/rahuldixit/UPI--,TRANSFER TO 9137022807,2597.37,,40234.51
22 Sep 2024,BY TRANSFER-UPI/CR/468864004558/ANITA P/ICIC/write2same/Dr Re--,TRANSFER FROM 9137022807,,2135.02,42369.53
20 Jul 2024,TO TRANSFER-UPI/DR/430265634978/ANITA P/SBIN/rohit@okhdfc/UPI--,TRANSFER TO 4897732162091,1637.42,,40732.11
14 Jul 2024,BY TRANSFER-UPI/CR/435687893946/MS SANJE/SBIN/spawar3290/Dr Re--,TRANSFER FROM 9137022807,,184.88,40916.99
21 Sep 2024,BY TRANSFER-UPI/CR/454680924631/PRIYA K/IDIB/anitapawar/Dr Re--,TRANSFER FROM 7382910045,,3405.08,44322.07
14 Jul 2024,TO TRANSFER-UPI/DR/427392149733/ROHIT T/SBIN/rohit@okhdfc/UPI--,TRANSFER TO 4897690162095,4623.45,,39698.62
14 Jul 2024,TO TRANSFER-UPI/DR/474587506965/MS SANJE/KKBK/write2same/UPI--,TRANSFER TO 4897690162095,3584.64,,36113.98
8 Jul 2024,BY TRANSFER-UPI/CR/425124078653/ANITA P/HDFC/rahuldixit/Dr Re--,TRANSFER FROM 4897732162091,,2488.47,38602.45
17 Jul 2024,BY TRANSFER-UPI/CR/483033823907/MS SANJE/KKBK/spawar3290/Dr Re--,TRANSFER FROM 9137022807,,3856.86,42459.31
17 Aug 2024,BY TRANSFER-UPI/CR/434802659012/SAGAR MO/SBIN/write2same/Dr Re--,TRANSFER FROM 9137022807,,3291.95,45751.26
23 Aug 2024,BY TRANSFER-UPI/CR/435943967183/PRIYA K/IDIB/rohit@okhdfc/Dr Re--,TRANSFER FROM 4897732162091,,4571.97,50323.23
27 Sep 2024,BY TRANSFER-UPI/CR/453469936190/ROHIT T/ICIC/rohit@okhdfc/Dr Re--,TRANSFER FROM 4897690162095,,694.99,51018.22
15 Sep 2024,TO TRANSFER-UPI/DR/478791371267/ROHIT T/IDIB/rohit@okhdfc/UPI--,TRANSFER TO 4897690162095,3106.45,,47911.77
14 Sep 2024,TO TRANSFER-UPI/DR/421648666475/MS SANJE/SBIN/rohit@okhdfc/UPI--,TRANSFER TO 4897732162091,4280.84,,43630.93
20 Aug 2024,TO TRANSFER-UPI/DR/447061376910/MS SANJE/IDIB/spawar3290/UPI--,TRANSFER TO 7382910045,4404.75,,39226.18
29 Sep 2024,BY TRANSFER-UPI/CR/445102342780/PRIYA K/HDFC/write2same/Dr Re--,TRANSFER FROM 4897732162091,,120.25,39346.43
1 Sep 2024,TO TRANSFER-UPI/DR/415416039124/SAMEER S/IDIB/write2same/UPI--,TRANSFER TO 4897690162095,3587.39,,35759.04
18 Sep 2024,TO TRANSFER-UPI/DR/490485173259/RAHUL D/SBIN/anitapawar/UPI--,TRANSFER TO 7382910045,4798.81,,30960.23
27 Sep 2024,TO TRANSFER-UPI/DR/474850275153/MS SANJE/IDIB/anitapawar/UPI--,TRANSFER TO 7382910045,4913.6,,26046.63
11 Jul 2024,BY TRANSFER-UPI/CR/448527216207/ROHIT T/SBIN/spawar3290/Dr Re--,TRANSFER FROM 8974521398,,4895.01,30941.64
5 Sep 2024,BY TRANSFER-UPI/CR/467525112969/ROHIT T/KKBK/anitapawar/Dr Re--,TRANSFER FROM 4897690162095,,1336.16,32277.8
22 Aug 2024,BY TRANSFER-UPI/CR/458766457420/SAMEER S/SBIN/spawar3290/Dr Re--,TRANSFER FROM 4897690162095,,2843.32,35121.12
17 Sep 2024,TO TRANSFER-UPI/DR/465559172231/MS SANJE/SBIN/rohit@okhdfc/UPI--,TRANSFER TO 9137022807,4554.35,,30566.77
30 Sep 2024,TO TRANSFER-UPI/DR/411071663214/ANITA P/ICIC/rahuldixit/UPI--,TRANSFER TO 4897690162095,3207.84,,27358.93
24 Aug 2024,BY TRANSFER-UPI/CR/438628192361/PRIYA K/KKBK/write2same/Dr Re--,TRANSFER FROM 4897732162091,,3986.08,31345.01
30 Aug 2024,TO TRANSFER-UPI/DR/458546827502/SAMEER S/KKBK/anitapawar/UPI--,TRANSFER TO 4897732162091,2814.32,,28530.69
26 Jul 2024,TO TRANSFER-UPI/DR/471739153824/ROHIT T/HDFC/rohit@okhdfc/UPI--,TRANSFER TO 7382910045,2468.81,,26061.88
11 Aug 2024,TO TRANSFER-UPI/DR/467814355603/MS SANJE/HDFC/anitapawar/UPI--,TRANSFER TO 8974521398,1293.47,,24768.41
15 Sep 2024,TO TRANSFER-UPI/DR/491914849908/PRIYA K/ICIC/spawar3290/UPI--,TRANSFER TO 9137022807,1990.6,,22777.81
27 Aug 2024,BY TRANSFER-UPI/CR/497573255875/SAGAR MO/HDFC/rohit@okhdfc/Dr Re--,TRANSFER FROM 7382910045,,1543.0,24320.81
13 Sep 2024,TO TRANSFER-UPI/DR/486675732818/SAGAR MO/ICIC/rohit@okhdfc/UPI--,TRANSFER TO 9137022807,283.46,,24037.35
18 Aug 2024,BY TRANSFER-UPI/CR/432323434772/RAHUL D/IDIB/rahuldixit/Dr Re--,TRANSFER FROM 4897690162095,,308.88,24346.23
10 Jul 2024,TO TRANSFER-UPI/DR/462846336550/ROHIT T/HDFC/rohit@okhdfc/UPI--,TRANSFER TO 8974521398,2775.05,,21571.18
14 Aug 2024,TO TRANSFER-UPI/DR/402847827438/ANITA P/SBIN/spawar3290/UPI--,TRANSFER TO 4897690162095,4462.49,,17108.69
29 Jul 2024,TO TRANSFER-UPI/DR/468032486899/PRIYA K/HDFC/anitapawar/UPI--,TRANSFER TO 9137022807,4126.52,,12982.17
9 Jul 2024,TO TRANSFER-UPI/DR/498886525090/PRIYA K/KKBK/rahuldixit/UPI--,TRANSFER TO 9137022807,2231.68,,10750.49
8 Jul 2024,BY TRANSFER-UPI/CR/492918572003/SAGAR MO/HDFC/rahuldixit/Dr Re--,TRANSFER FROM 8974521398,,2657.58,13408.07
14 Jul 2024,TO TRANSFER-UPI/DR/465063233771/RAHUL D/HDFC/anitapawar/UPI--,TRANSFER TO 4897690162095,4546.11,,8861.96
6 Aug 2024,TO TRANSFER-UPI/DR/445217223548/ANITA P/ICIC/spawar3290/UPI--,TRANSFER TO 8974521398,4362.37,,4499.59
24 Jul 2024,TO TRANSFER-UPI/DR/461559377447/SAGAR MO/SBIN/rahuldixit/UPI--,TRANSFER TO 4897732162091,4713.63,,-214.04
4 Aug 2024,TO TRANSFER-UPI/DR/457235015076/PRIYA K/ICIC/spawar3290/UPI--,TRANSFER TO 8974521398,2882.79,,-3096.83
12 Aug 2024,BY TRANSFER-UPI/CR/471174859557/SAGAR MO/SBIN/anitapawar/Dr Re--,TRANSFER FROM 4897732162091,,2409.22,-687.61
9 Aug 2024,TO TRANSFER-UPI/DR/499194112793/SAMEER S/ICIC/spawar3290/UPI--,TRANSFER TO 8974521398,1196.77,,-1884.38
31 Aug 2024,BY TRANSFER-UPI/CR/487980510363/PRIYA K/IDIB/spawar3290/Dr Re--,TRANSFER FROM 9137022807,,1079.59,-804.79
15 Aug 2024,BY TRANSFER-UPI/CR/486202378346/PRIYA K/SBIN/rahuldixit/Dr Re--,TRANSFER FROM 8974521398,,1188.94,384.15
15 Sep 2024,TO TRANSFER-UPI/DR/480779291631/SAMEER S/KKBK/spawar3290/UPI--,TRANSFER TO 4897732162091,328.04,,56.11
26 Jul 2024,BY TRANSFER-UPI/CR/435291651866/SAMEER S/HDFC/anitapawar/Dr Re--,TRANSFER FROM 4897732162091,,3289.77,3345.88
16 Aug 2024,TO TRANSFER-UPI/DR/407361915359/SAMEER S/HDFC/spawar3290/UPI--,TRANSFER TO 4897732162091,3139.2,,206.68
22 Jul 2024,BY TRANSFER-UPI/CR/498091613305/MS SANJE/HDFC/rahuldixit/Dr Re--,TRANSFER FROM 4897732162091,,4100.03,4306.71
30 Jul 2024,TO TRANSFER-UPI/DR/428122432657/SAMEER S/SBIN/write2same/UPI--,TRANSFER TO 7382910045,799.66,,3507.05
11 Aug 2024,BY TRANSFER-UPI/CR/401997400224/ANITA P/SBIN/write2same/Dr Re--,TRANSFER FROM 4897732162091,,4474.57,7981.62
28 Sep 2024,TO TRANSFER-UPI/DR/449179338152/PRIYA K/IDIB/spawar3290/UPI--,TRANSFER TO 9137022807,4574.39,,3407.23
20 Aug 2024,BY TRANSFER-UPI/CR/479849937724/RAHUL D/ICIC/spawar3290/Dr Re--,TRANSFER FROM 7382910045,,2161.04,5568.27
2 Sep 2024,BY TRANSFER-UPI/CR/470511821969/PRIYA K/KKBK/spawar3290/Dr Re--,TRANSFER FROM 4897690162095,,1608.59,7176.86
11 Sep 2024,TO TRANSFER-UPI/DR/436343070077/SAMEER S/SBIN/spawar3290/UPI--,TRANSFER TO 8974521398,547.24,,6629.62
14 Sep 2024,BY TRANSFER-UPI/CR/412297728961/ROHIT T/SBIN/rahuldixit/Dr Re--,TRANSFER FROM 4897732162091,,1683.57,8313.19
2 Sep 2024,TO TRANSFER-UPI/DR/498842780591/RAHUL D/ICIC/write2same/UPI--,TRANSFER TO 7382910045,1733.52,,6579.67
1 Jul 2024,BY TRANSFER-UPI/CR/452466084299/MS SANJE/KKBK/spawar3290/Dr Re--,TRANSFER FROM 7382910045,,4455.27,11034.94
15 Aug 2024,BY TRANSFER-UPI/CR/424823941913/SAGAR MO/ICIC/rohit@okhdfc/Dr Re--,TRANSFER FROM 4897690162095,,2031.0,13065.94
25 Sep 2024,BY TRANSFER-UPI/CR/476875977996/SAGAR MO/SBIN/spawar3290/Dr Re--,TRANSFER FROM 4897690162095,,3970.11,17036.05
5 Aug 2024,BY TRANSFER-UPI/CR/443777497883/SAMEER S/ICIC/anitapawar/Dr Re--,TRANSFER FROM 7382910045,,390.32,17426.37
8 Aug 2024,BY TRANSFER-UPI/CR/401269654686/ANITA P/ICIC/rohit@okhdfc/Dr Re--,TRANSFER FROM 8974521398,,1794.98,19221.35
10 Aug 2024,TO TRANSFER-UPI/DR/428788954219/SAMEER S/SBIN/write2same/UPI--,TRANSFER TO 8974521398,776.19,,18445.16
16 Sep 2024,BY TRANSFER-UPI/CR/421438360511/SAMEER S/KKBK/anitapawar/Dr Re--,TRANSFER FROM 7382910045,,3953.49,22398.65
18 Aug 2024,BY TRANSFER-UPI/CR/428697660886/PRIYA K/SBIN/rohit@okhdfc/Dr Re--,TRANSFER FROM 4897732162091,,3112.44,25511.09
12 Sep 2024,TO TRANSFER-UPI/DR/411291325753/SAGAR MO/ICIC/write2same/UPI--,TRANSFER TO 4897690162095,694.4,,24816.69
7 Aug 2024,BY TRANSFER-UPI/CR/412183152161/ANITA P/ICIC/spawar3290/Dr Re--,TRANSFER FROM 8974521398,,3861.8,28678.49
31 Jul 2024,TO TRANSFER-UPI/DR/428031512942/RAHUL D/SBIN/anitapawar/UPI--,TRANSFER TO 7382910045,2668.18,,26010.31
8 Jul 2024,BY TRANSFER-UPI/CR/433389469379/MS SANJE/SBIN/rohit@okhdfc/Dr Re--,TRANSFER FROM 4897732162091,,1879.29,27889.6
21 Sep 2024,BY TRANSFER-UPI/CR/481298027323/ROHIT T/KKBK/rohit@okhdfc/Dr Re--,TRANSFER FROM 4897732162091,,4644.91,32534.51
28 Sep 2024,TO TRANSFER-UPI/DR/433301257578/ROHIT T/ICIC/spawar3290/UPI--,TRANSFER TO 4897732162091,1790.73,,30743.78
12 Aug 2024,TO TRANSFER-UPI/DR/425277359124/RAHUL D/ICIC/spawar3290/UPI--,TRANSFER TO 8974521398,4757.76,,25986.02
8 Aug 2024,BY TRANSFER-UPI/CR/401974271895/ANITA P/IDIB/anitapawar/Dr Re--,TRANSFER FROM 4897732162091,,4872.74,30858.76
6 Jul 2024,TO TRANSFER-UPI/DR/453969873029/MS SANJE/SBIN/anitapawar/UPI--,TRANSFER TO 4897690162095,3214.41,,27644.35
1 Jul 2024,TO TRANSFER-UPI/DR/406794477719/MS SANJE/KKBK/spawar3290/UPI--,TRANSFER TO 7382910045,658.74,,26985.61
5 Jul 2024,BY TRANSFER-UPI/CR/492931397711/ANITA P/KKBK/rohit@okhdfc/Dr Re--,TRANSFER FROM 9137022807,,2828.97,29814.58
23 Aug 2024,BY TRANSFER-UPI/CR/472807020597/RAHUL D/ICIC/rohit@okhdfc/Dr Re--,TRANSFER FROM 7382910045,,4667.31,34481.89
17 Aug 2024,BY TRANSFER-UPI/CR/449256755075/RAHUL D/SBIN/rahuldixit/Dr Re--,TRANSFER FROM 9137022807,,1396.22,35878.11
11 Jul 2024,BY TRANSFER-UPI/CR/460283854328/PRIYA K/HDFC/write2same/Dr Re--,TRANSFER FROM 9137022807,,377.17,36255.28
11 Sep 2024,BY TRANSFER-UPI/CR/494506120293/ANITA P/KKBK/spawar3290/Dr Re--,TRANSFER FROM 4897690162095,,3490.11,39745.39
8 Aug 2024,BY TRANSFER-UPI/CR/426164737936/RAHUL D/SBIN/rahuldixit/Dr Re--,TRANSFER FROM 9137022807,,153.22,39898.61
19 Aug 2024,TO TRANSFER-UPI/DR/438051562297/SAGAR MO/ICIC/rahuldixit/UPI--,TRANSFER TO 4897732162091,4182.91,,35715.7
19 Jul 2024,TO TRANSFER-UPI/DR/455382024475/MS SANJE/ICIC/rahuldixit/UPI--,TRANSFER TO 7382910045,4723.99,,30991.71
20 Aug 2024,BY TRANSFER-UPI/CR/434097152351/RAHUL D/SBIN/rohit@okhdfc/Dr Re--,TRANSFER FROM 7382910045,,909.74,31901.45
20 Aug 2024,TO TRANSFER-UPI/DR/451375757819/SAMEER S/HDFC/rahuldixit/UPI--,TRANSFER TO 9137022807,2609.27,,29292.18
9 Jul 2024,TO TRANSFER-UPI/DR/430797674554/PRIYA K/IDIB/rohit@okhdfc/UPI--,TRANSFER TO 4897732162091,4045.12,,25247.06
11 Aug 2024,TO TRANSFER-UPI/DR/417801266951/SAMEER S/ICIC/write2same/UPI--,TRANSFER TO 7382910045,3276.72,,21970.34
16 Aug 2024,BY TRANSFER-UPI/CR/461867435221/PRIYA K/ICIC/rohit@okhdfc/Dr Re--,TRANSFER FROM 9137022807,,4301.66,26272.0
30 Sep 2024,TO TRANSFER-UPI/DR/472134575267/RAHUL D/KKBK/spawar3290/UPI--,TRANSFER TO 4897690162095,1162.36,,25109.64
25 Jul 2024,BY TRANSFER-UPI/CR/465321827976/MS SANJE/HDFC/anitapawar/Dr Re--,TRANSFER FROM 4897690162095,,3120.6,28230.24
6 Aug 2024,BY TRANSFER-UPI/CR/463282373475/RAHUL D/HDFC/rohit@okhdfc/Dr Re--,TRANSFER FROM 4897690162095,,193.65,28423.89
18 Sep 2024,TO TRANSFER-UPI/DR/474911358286/ROHIT T/HDFC/spawar3290/UPI--,TRANSFER TO 9137022807,3592.1,,24831.79
16 Aug 2024,BY TRANSFER-UPI/CR/420954321322/RAHUL D/ICIC/spawar3290/Dr Re--,TRANSFER FROM 7382910045,,1697.27,26529.06
10 Aug 2024,BY TRANSFER-UPI/CR/440071803438/PRIYA K/HDFC/write2same/Dr Re--,TRANSFER FROM 7382910045,,4143.22,30672.28
13 Aug 2024,BY TRANSFER-UPI/CR/423683260483/PRIYA K/HDFC/rahuldixit/Dr Re--,TRANSFER FROM 8974521398,,3667.77,34340.05
16 Jul 2024,BY TRANSFER-UPI/CR/470294810451/ROHIT T/ICIC/rahuldixit/Dr Re--,TRANSFER FROM 7382910045,,2812.61,37152.66
23 Aug 2024,TO TRANSFER-UPI/DR/462597318080/MS SANJE/ICIC/write2same/UPI--,TRANSFER TO 9137022807,3881.62,,33271.04
5 Aug 2024,BY TRANSFER-UPI/CR/480822306884/ROHIT T/HDFC/rahuldixit/Dr Re--,TRANSFER FROM 9137022807,,3492.57,36763.61
12 Aug 2024,BY TRANSFER-UPI/CR/461136688122/RAHUL D/HDFC/rohit@okhdfc/Dr Re--,TRANSFER FROM 4897690162095,,3318.68,40082.29
17 Jul 2024,BY TRANSFER-UPI/CR/456035716544/PRIYA K/ICIC/anitapawar/Dr Re--,TRANSFER FROM 4897690162095,,2751.72,42834.01
20 Sep 2024,TO TRANSFER-UPI/DR/487908709007/PRIYA K/KKBK/anitapawar/UPI--,TRANSFER TO 4897690162095,309.75,,42524.26
31 Aug 2024,TO TRANSFER-UPI/DR/430622793267/RAHUL D/KKBK/rahuldixit/UPI--,TRANSFER TO 9137022807,3458.97,,39065.29
19 Aug 2024,TO TRANSFER-UPI/DR/467856641485/SAMEER S/ICIC/rahuldixit/UPI--,TRANSFER TO 7382910045,1617.8,,37447.49
1 Aug 2024,TO TRANSFER-UPI/DR/433761800371/SAMEER S/SBIN/write2same/UPI--,TRANSFER TO 4897690162095,2551.81,,34895.68
4 Aug 2024,BY TRANSFER-UPI/CR/412805295053/SAGAR MO/HDFC/rahuldixit/Dr Re--,TRANSFER FROM 9137022807,,2213.77,37109.45
23 Aug 2024,BY TRANSFER-UPI/CR/417425068992/MS SANJE/SBIN/anitapawar/Dr Re--,TRANSFER FROM 8974521398,,2394.94,39504.39
27 Aug 2024,BY TRANSFER-UPI/CR/478138986100/PRIYA K/IDIB/rahuldixit/Dr Re--,TRANSFER FROM 7382910045,,2092.86,41597.25
30 Aug 2024,TO TRANSFER-UPI/DR/461570217528/RAHUL D/KKBK/rohit@okhdfc/UPI--,TRANSFER TO 4897732162091,2939.92,,38657.33
1 Sep 2024,TO TRANSFER-UPI/DR/447868950707/MS SANJE/ICIC/spawar3290/UPI--,TRANSFER TO 4897732162091,806.57,,37850.76
27 Jul 2024,TO TRANSFER-UPI/DR/478401363750/ANITA P/KKBK/rahuldixit/UPI--,TRANSFER TO 4897690162095,4535.46,,33315.3
20 Jul 2024,BY TRANSFER-UPI/CR/426280222952/ROHIT T/ICIC/rahuldixit/Dr Re--,TRANSFER FROM 4897732162091,,4989.64,38304.94
9 Aug 2024,TO TRANSFER-UPI/DR/486299316414/ANITA P/SBIN/write2same/UPI--,TRANSFER TO 7382910045,3982.42,,34322.52
18 Jul 2024,BY TRANSFER-UPI/CR/401134255150/ANITA P/ICIC/write2same/Dr Re--,TRANSFER FROM 9137022807,,558.68,34881.2
8 Aug 2024,BY TRANSFER-UPI/CR/408892705269/ANITA P/ICIC/rohit@okhdfc/Dr Re--,TRANSFER FROM 9137022807,,4857.94,39739.14
26 Sep 2024,BY TRANSFER-UPI/CR/469613228560/SAGAR MO/KKBK/anitapawar/Dr Re--,TRANSFER FROM 4897732162091,,1808.9,41548.04
28 Aug 2024,TO TRANSFER-UPI/DR/497882025573/SAGAR MO/ICIC/write2same/UPI--,TRANSFER TO 9137022807,3239.32,,38308.72
21 Jul 2024,TO TRANSFER-UPI/DR/473209181979/ROHIT T/ICIC/write2same/UPI--,TRANSFER TO 4897690162095,3155.84,,35152.88
8 Aug 2024,BY TRANSFER-UPI/CR/474760157459/PRIYA K/SBIN/spawar3290/Dr Re--,TRANSFER FROM 8974521398,,3300.1,38452.98
5 Jul 2024,TO TRANSFER-UPI/DR/422010209734/PRIYA K/HDFC/spawar3290/UPI--,TRANSFER TO 4897690162095,2356.86,,36096.12
19 Jul 2024,BY TRANSFER-UPI/CR/439120504378/MS SANJE/SBIN/rohit@okhdfc/Dr Re--,TRANSFER FROM 7382910045,,733.7,36829.82
12 Aug 2024,BY TRANSFER-UPI/CR/468383780057/SAGAR MO/IDIB/rahuldixit/Dr Re--,TRANSFER FROM 4897690162095,,233.77,37063.59
12 Aug 2024,TO TRANSFER-UPI/DR/465121280072/SAMEER S/SBIN/spawar3290/UPI--,TRANSFER TO 4897732162091,4925.45,,32138.14
21 Jul 2024,TO TRANSFER-UPI/DR/469100647842/MS SANJE/HDFC/spawar3290/UPI--,TRANSFER TO 9137022807,2062.89,,30075.25
2 Jul 2024,BY TRANSFER-UPI/CR/461085286638/ROHIT T/IDIB/spawar3290/Dr Re--,TRANSFER FROM 9137022807,,1703.42,31778.67
8 Jul 2024,BY TRANSFER-UPI/CR/402035799975/ANITA P/HDFC/rahuldixit/Dr Re--,TRANSFER FROM 7382910045,,4360.95,36139.62
8 Aug 2024,TO TRANSFER-UPI/DR/490248147754/SAMEER S/KKBK/anitapawar/UPI--,TRANSFER TO 7382910045,4797.72,,31341.9
28 Jul 2024,BY TRANSFER-UPI/CR/493161728260/PRIYA K/KKBK/rohit@okhdfc/Dr Re--,TRANSFER FROM 9137022807,,579.05,31920.95
19 Jul 2024,BY TRANSFER-UPI/CR/489900727352/RAHUL D/KKBK/write2same/Dr Re--,TRANSFER FROM 7382910045,,4910.46,36831.41
10 Sep 2024,TO TRANSFER-UPI/DR/411668545520/ANITA P/SBIN/spawar3290/UPI--,TRANSFER TO 7382910045,3090.99,,33740.42
8 Jul 2024,BY TRANSFER-UPI/CR/492490449929/RAHUL D/KKBK/write2same/Dr Re--,TRANSFER FROM 9137022807,,4458.68,38199.1
5 Sep 2024,TO TRANSFER-UPI/DR/476888821220/MS SANJE/KKBK/rohit@okhdfc/UPI--,TRANSFER TO 9137022807,3664.81,,34534.29
1 Jul 2024,BY TRANSFER-UPI/CR/423391024568/PRIYA K/KKBK/write2same/Dr Re--,TRANSFER FROM 4897690162095,,2237.11,36771.4
24 Aug 2024,TO TRANSFER-UPI/DR/409702825209/MS SANJE/HDFC/write2same/UPI--,TRANSFER TO 4897732162091,4593.11,,32178.29
6 Jul 2024,BY TRANSFER-UPI/CR/432800554459/ANITA P/IDIB/rohit@okhdfc/Dr Re--,TRANSFER FROM 9137022807,,3341.43,35519.72
4 Jul 2024,TO TRANSFER-UPI/DR/491438679110/ANITA P/IDIB/rahuldixit/UPI--,TRANSFER TO 7382910045,970.96,,34548.76
9 Aug 2024,TO TRANSFER-UPI/DR/431169253573/PRIYA K/KKBK/rahuldixit/UPI--,TRANSFER TO 9137022807,1589.0,,32959.76
15 Jul 2024,BY TRANSFER-UPI/CR/456218924471/ROHIT T/IDIB/rahuldixit/Dr Re--,TRANSFER FROM 4897732162091,,2928.87,35888.63
15 Jul 2024,BY TRANSFER-UPI/CR/458023260402/ROHIT T/ICIC/anitapawar/Dr Re--,TRANSFER FROM 4897732162091,,4517.39,40406.02
27 Sep 2024,BY TRANSFER-UPI/CR/489630816286/MS SANJE/IDIB/spawar3290/Dr Re--,TRANSFER FROM 4897690162095,,3222.2,43628.22
27 Sep 2024,TO TRANSFER-UPI/DR/487751843481/SAMEER S/SBIN/write2same/UPI--,TRANSFER TO 4897732162091,1133.27,,42494.95
4 Sep 2024,BY TRANSFER-UPI/CR/480123822015/RAHUL D/IDIB/write2same/Dr Re--,TRANSFER FROM 8974521398,,88.89,42583.84
28 Sep 2024,BY TRANSFER-UPI/CR/478234534348/MS SANJE/IDIB/write2same/Dr Re--,TRANSFER FROM 4897690162095,,4114.43,46698.27
25 Sep 2024,BY TRANSFER-UPI/CR/453715756967/PRIYA K/HDFC/rohit@okhdfc/Dr Re--,TRANSFER FROM 4897690162095,,1919.17,48617.44
18 Jul 2024,BY TRANSFER-UPI/CR/402092093896/SAMEER S/ICIC/spawar3290/Dr Re--,TRANSFER FROM 7382910045,,1621.92,50239.36
22 Jul 2024,TO TRANSFER-UPI/DR/485071525129/ANITA P/IDIB/anitapawar/UPI--,TRANSFER TO 9137022807,4203.11,,46036.25
3 Sep 2024,TO TRANSFER-UPI/DR/447489377345/MS SANJE/KKBK/rahuldixit/UPI--,TRANSFER TO 8974521398,2071.93,,43964.32
23 Jul 2024,BY TRANSFER-UPI/CR/451085742527/MS SANJE/KKBK/write2same/Dr Re--,TRANSFER FROM 4897732162091,,2473.22,46437.54
25 Sep 2024,TO TRANSFER-UPI/DR/418126149539/PRIYA K/HDFC/spawar3290/UPI--,TRANSFER TO 7382910045,1162.52,,45275.02
26 Jul 2024,TO TRANSFER-UPI/DR/481137290868/SAGAR MO/KKBK/anitapawar/UPI--,TRANSFER TO 8974521398,79.14,,45195.88
15 Jul 2024,TO TRANSFER-UPI/DR/433577633280/SAGAR MO/ICIC/spawar3290/UPI--,TRANSFER TO 4897690162095,1333.09,,43862.79
10 Aug 2024,TO TRANSFER-UPI/DR/465643438562/RAHUL D/IDIB/write2same/UPI--,TRANSFER TO 9137022807,4471.4,,39391.39
12 Aug 2024,TO TRANSFER-UPI/DR/441969839920/RAHUL D/ICIC/write2same/UPI--,TRANSFER TO 7382910045,2236.37,,37155.02
1 Aug 2024,BY TRANSFER-UPI/CR/424083998937/RAHUL D/IDIB/rohit@okhdfc/Dr Re--,TRANSFER FROM 9137022807,,1230.47,38385.49
15 Sep 2024,TO TRANSFER-UPI/DR/425836680631/MS SANJE/KKBK/rahuldixit/UPI--,TRANSFER TO 4897690162095,1314.87,,37070.62
24 Jul 2024,TO TRANSFER-UPI/DR/440052508105/ROHIT T/HDFC/write2same/UPI--,TRANSFER TO 9137022807,1233.13,,35837.49
29 Sep 2024,BY TRANSFER-UPI/CR/415052619645/ROHIT T/SBIN/rohit@okhdfc/Dr Re--,TRANSFER FROM 8974521398,,1642.52,37480.01
12 Jul 2024,BY TRANSFER-UPI/CR/477281968927/ANITA P/IDIB/rohit@okhdfc/Dr Re--,TRANSFER FROM 9137022807,,3327.51,40807.52
17 Jul 2024,BY TRANSFER-UPI/CR/447643392116/ANITA P/KKBK/anitapawar/Dr Re--,TRANSFER FROM 8974521398,,3706.88,44514.4
6 Sep 2024,TO TRANSFER-UPI/DR/424072142099/ANITA P/KKBK/rohit@okhdfc/UPI--,TRANSFER TO 7382910045,4925.06,,39589.34
8 Jul 2024,BY TRANSFER-UPI/CR/499164296454/RAHUL D/KKBK/rohit@okhdfc/Dr Re--,TRANSFER FROM 4897690162095,,3070.56,42659.9
17 Sep 2024,BY TRANSFER-UPI/CR/458283201317/PRIYA K/HDFC/anitapawar/Dr Re--,TRANSFER FROM 4897690162095,,3724.64,46384.54
21 Aug 2024,TO TRANSFER-UPI/DR/427800247987/PRIYA K/KKBK/anitapawar/UPI--,TRANSFER TO 8974521398,1594.11,,44790.43
28 Jul 2024,TO TRANSFER-UPI/DR/446933467433/SAMEER S/ICIC/rahuldixit/UPI--,TRANSFER TO 4897732162091,1329.68,,43460.75
7 Aug 2024,BY TRANSFER-UPI/CR/405650752567/SAGAR MO/KKBK/rohit@okhdfc/Dr Re--,TRANSFER FROM 8974521398,,2054.68,45515.43
11 Sep 2024,BY TRANSFER-UPI/CR/421960805941/ANITA P/ICIC/anitapawar/Dr Re--,TRANSFER FROM 9137022807,,4467.21,49982.64
6 Jul 2024,BY TRANSFER-UPI/CR/404144485065/PRIYA K/ICIC/rohit@okhdfc/Dr Re--,TRANSFER FROM 8974521398,,496.12,50478.76
23 Jul 2024,BY TRANSFER-UPI/CR/466107312060/ANITA P/ICIC/write2same/Dr Re--,TRANSFER FROM 9137022807,,4723.01,55201.77
19 Jul 2024,BY TRANSFER-UPI/CR/495673590974/SAMEER S/SBIN/rahuldixit/Dr Re--,TRANSFER FROM 9137022807,,3374.56,58576.33
10 Jul 2024,BY TRANSFER-UPI/CR/428777487294/ROHIT T/ICIC/spawar3290/Dr Re--,TRANSFER FROM 7382910045,,4376.1,62952.43
11 Jul 2024,BY TRANSFER-UPI/CR/446633105858/PRIYA K/ICIC/write2same/Dr Re--,TRANSFER FROM 8974521398,,4227.57,67180.0
14 Aug 2024,TO TRANSFER-UPI/DR/472979871549/RAHUL D/IDIB/spawar3290/UPI--,TRANSFER TO 9137022807,3166.97,,64013.03
28 Aug 2024,TO TRANSFER-UPI/DR/416810745605/PRIYA K/IDIB/spawar3290/UPI--,TRANSFER TO 7382910045,989.23,,63023.8
7 Jul 2024,TO TRANSFER-UPI/DR/414101232780/MS SANJE/SBIN/rohit@okhdfc/UPI--,TRANSFER TO 9137022807,1401.63,,61622.17
2 Sep 2024,TO TRANSFER-UPI/DR/420738991651/MS SANJE/IDIB/write2same/UPI--,TRANSFER TO 4897732162091,1019.32,,60602.85
9 Sep 2024,TO TRANSFER-UPI/DR/418480971545/SAGAR MO/SBIN/rahuldixit/UPI--,TRANSFER TO 8974521398,3244.38,,57358.47
7 Jul 2024,TO TRANSFER-UPI/DR/405433960684/PRIYA K/IDIB/rahuldixit/UPI--,TRANSFER TO 4897732162091,2335.18,,55023.29
27 Jul 2024,BY TRANSFER-UPI/CR/436999367140/MS SANJE/HDFC/rohit@okhdfc/Dr Re--,TRANSFER FROM 7382910045,,1439.98,56463.27
5 Jul 2024,BY TRANSFER-UPI/CR/440703922652/MS SANJE/KKBK/rohit@okhdfc/Dr Re--,TRANSFER FROM 4897732162091,,3085.11,59548.38
23 Jul 2024,BY TRANSFER-UPI/CR/416873665125/SAGAR MO/IDIB/anitapawar/Dr Re--,TRANSFER FROM 4897732162091,,816.99,60365.37
4 Sep 2024,TO TRANSFER-UPI/DR/458948492694/RAHUL D/KKBK/spawar3290/UPI--,TRANSFER TO 9137022807,56.02,,60309.35
22 Jul 2024,BY TRANSFER-UPI/CR/428161768770/ROHIT T/IDIB/rahuldixit/Dr Re--,TRANSFER FROM 4897690162095,,4098.27,64407.62
5 Aug 2024,TO TRANSFER-UPI/DR/441573359968/PRIYA K/SBIN/anitapawar/UPI--,TRANSFER TO 4897732162091,4374.12,,60033.5
6 Sep 2024,BY TRANSFER-UPI/CR/492830432818/PRIYA K/HDFC/write2same/Dr Re--,TRANSFER FROM 4897690162095,,4652.63,64686.13
1 Sep 2024,BY TRANSFER-UPI/CR/486783125572/MS SANJE/SBIN/write2same/Dr Re--,TRANSFER FROM 4897732162091,,3708.39,68394.52
27 Aug 2024,TO TRANSFER-UPI/DR/477647742145/ANITA P/KKBK/spawar3290/UPI--,TRANSFER TO 7382910045,1933.19,,66461.33
27 Sep 2024,BY TRANSFER-UPI/CR/465556605917/SAMEER S/HDFC/anitapawar/Dr Re--,TRANSFER FROM 8974521398,,2968.82,69430.15
8 Jul 2024,TO TRANSFER-UPI/DR/420774704265/ROHIT T/HDFC/rohit@okhdfc/UPI--,TRANSFER TO 8974521398,3585.14,,65845.01
15 Sep 2024,BY TRANSFER-UPI/CR/477273910889/PRIYA K/HDFC/write2same/Dr Re--,TRANSFER FROM 4897732162091,,4482.24,70327.25
19 Aug 2024,TO TRANSFER-UPI/DR/436013221169/RAHUL D/KKBK/rohit@okhdfc/UPI--,TRANSFER TO 7382910045,2289.92,,68037.33
4 Sep 2024,TO TRANSFER-UPI/DR/485999797168/ROHIT T/KKBK/spawar3290/UPI--,TRANSFER TO 9137022807,1169.59,,66867.74
9 Aug 2024,TO TRANSFER-UPI/DR/429543783940/PRIYA K/KKBK/rahuldixit/UPI--,TRANSFER TO 7382910045,849.05,,66018.69
2 Jul 2024,TO TRANSFER-UPI/DR/461739050070/PRIYA K/HDFC/anitapawar/UPI--,TRANSFER TO 7382910045,2731.28,,63287.41
19 Sep 2024,BY TRANSFER-UPI/CR/486798350714/MS SANJE/SBIN/write2same/Dr Re--,TRANSFER FROM 9137022807,,3553.41,66840.82
20 Sep 2024,TO TRANSFER-UPI/DR/409935448297/MS SANJE/IDIB/rahuldixit/UPI--,TRANSFER TO 9137022807,1252.85,,65587.97
8 Aug 2024,TO TRANSFER-UPI/DR/436005974980/SAMEER S/ICIC/spawar3290/UPI--,TRANSFER TO 4897732162091,3627.76,,61960.21
9 Jul 2024,TO TRANSFER-UPI/DR/492553159656/ANITA P/SBIN/rahuldixit/UPI--,TRANSFER TO 4897690162095,589.89,,61370.32
22 Aug 2024,BY TRANSFER-UPI/CR/461454849753/PRIYA K/HDFC/rahuldixit/Dr Re--,TRANSFER FROM 8974521398,,3611.31,64981.63
20 Jul 2024,TO TRANSFER-UPI/DR/465062765751/PRIYA K/HDFC/spawar3290/UPI--,TRANSFER TO 8974521398,351.3,,64630.33
20 Sep 2024,BY TRANSFER-UPI/CR/422845593030/ROHIT T/SBIN/anitapawar/Dr Re--,TRANSFER FROM 9137022807,,3693.36,68323.69
19 Sep 2024,BY TRANSFER-UPI/CR/402210546544/RAHUL D/KKBK/rohit@okhdfc/Dr Re--,TRANSFER FROM 4897690162095,,3172.22,71495.91
21 Aug 2024,TO TRANSFER-UPI/DR/486957480247/PRIYA K/ICIC/rohit@okhdfc/UPI--,TRANSFER TO 7382910045,1853.82,,69642.09
26 Aug 2024,BY TRANSFER-UPI/CR/423541503812/MS SANJE/KKBK/spawar3290/Dr Re--,TRANSFER FROM 7382910045,,3614.48,73256.57
7 Aug 2024,TO TRANSFER-UPI/DR/412198955114/SAMEER S/KKBK/write2same/UPI--,TRANSFER TO 4897690162095,1474.17,,71782.4
14 Jul 2024,BY TRANSFER-UPI/CR/426411918293/ANITA P/IDIB/anitapawar/Dr Re--,TRANSFER FROM 8974521398,,3114.54,74896.94
14 Sep 2024,TO TRANSFER-UPI/DR/488711983365/RAHUL D/SBIN/spawar3290/UPI--,TRANSFER TO 4897732162091,4877.99,,70018.95
31 Aug 2024,TO TRANSFER-UPI/DR/404825509095/MS SANJE/IDIB/rohit@okhdfc/UPI--,TRANSFER TO 4897690162095,4792.2,,65226.75
23 Aug 2024,BY TRANSFER-UPI/CR/473185369262/ROHIT T/SBIN/spawar3290/Dr Re--,TRANSFER FROM 4897732162091,,2506.78,67733.53
4 Aug 2024,TO TRANSFER-UPI/DR/424161297584/ROHIT T/SBIN/rohit@okhdfc/UPI--,TRANSFER TO 4897690162095,3120.83,,64612.7
30 Aug 2024,BY TRANSFER-UPI/CR/421890918101/SAMEER S/KKBK/write2same/Dr Re--,TRANSFER FROM 7382910045,,2102.01,66714.71
26 Aug 2024,BY TRANSFER-UPI/CR/456812002874/ANITA P/KKBK/spawar3290/Dr Re--,TRANSFER FROM 9137022807,,4523.99,71238.7
28 Jul 2024,BY TRANSFER-UPI/CR/414796822066/SAMEER S/KKBK/write2same/Dr Re--,TRANSFER FROM 4897732162091,,4951.84,76190.54
8 Sep 2024,TO TRANSFER-UPI/DR/407707615904/PRIYA K/HDFC/anitapawar/UPI--,TRANSFER TO 4897690162095,3353.18,,72837.36
26 Sep 2024,TO TRANSFER-UPI/DR/409938984868/RAHUL D/IDIB/anitapawar/UPI--,TRANSFER TO 9137022807,4063.65,,68773.71
9 Sep 2024,BY TRANSFER-UPI/CR/432985606220/SAMEER S/KKBK/rahuldixit/Dr Re--,TRANSFER FROM 7382910045,,1184.86,69958.57
1 Sep 2024,TO TRANSFER-UPI/DR/449862598585/SAMEER S/IDIB/spawar3290/UPI--,TRANSFER TO 4897732162091,3371.42,,66587.15
9 Jul 2024,BY TRANSFER-UPI/CR/462975624899/RAHUL D/KKBK/rahuldixit/Dr Re--,TRANSFER FROM 4897690162095,,4369.96,70957.11
15 Sep 2024,TO TRANSFER-UPI/DR/445518754946/RAHUL D/SBIN/anitapawar/UPI--,TRANSFER TO 9137022807,1470.72,,69486.39
20 Jul 2024,TO TRANSFER-UPI/DR/497050814442/PRIYA K/KKBK/anitapawar/UPI--,TRANSFER TO 8974521398,2687.85,,66798.54
26 Aug 2024,BY TRANSFER-UPI/CR/477759529769/PRIYA K/SBIN/rohit@okhdfc/Dr Re--,TRANSFER FROM 4897732162091,,1544.36,68342.9
9 Jul 2024,TO TRANSFER-UPI/DR/494416147939/PRIYA K/ICIC/anitapawar/UPI--,TRANSFER TO 4897732162091,1106.52,,67236.38
28 Jul 2024,TO TRANSFER-UPI/DR/424858693652/SAGAR MO/HDFC/spawar3290/UPI--,TRANSFER TO 9137022807,621.02,,66615.36
15 Jul 2024,BY TRANSFER-UPI/CR/434405738250/SAMEER S/ICIC/rohit@okhdfc/Dr Re--,TRANSFER FROM 8974521398,,1135.31,67750.67
30 Sep 2024,TO TRANSFER-UPI/DR/460371143165/MS SANJE/HDFC/anitapawar/UPI--,TRANSFER TO 7382910045,4085.47,,63665.2
6 Jul 2024,TO TRANSFER-UPI/DR/482298214438/MS SANJE/IDIB/anitapawar/UPI--,TRANSFER TO 9137022807,330.58,,63334.62
4 Sep 2024,BY TRANSFER-UPI/CR/400753695932/PRIYA K/ICIC/anitapawar/Dr Re--,TRANSFER FROM 8974521398,,1355.64,64690.26
14 Aug 2024,TO TRANSFER-UPI/DR/416262223256/SAMEER S/IDIB/anitapawar/UPI--,TRANSFER TO 4897732162091,3807.42,,60882.84
22 Jul 2024,TO TRANSFER-UPI/DR/425381762594/ROHIT T/HDFC/spawar3290/UPI--,TRANSFER TO 7382910045,1016.83,,59866.01
29 Aug 2024,TO TRANSFER-UPI/DR/450360723141/RAHUL D/IDIB/anitapawar/UPI--,TRANSFER TO 7382910045,4980.87,,54885.14
15 Aug 2024,BY TRANSFER-UPI/CR/482931933972/SAGAR MO/SBIN/rohit@okhdfc/Dr Re--,TRANSFER FROM 9137022807,,2110.05,56995.19
5 Jul 2024,BY TRANSFER-UPI/CR/400943650244/RAHUL D/SBIN/rahuldixit/Dr Re--,TRANSFER FROM 4897732162091,,166.46,57161.65
10 Aug 2024,TO TRANSFER-UPI/DR/403953285880/SAMEER S/KKBK/anitapawar/UPI--,TRANSFER TO 4897732162091,4512.92,,52648.73
29 Aug 2024,BY TRANSFER-UPI/CR/422137181560/SAMEER S/HDFC/anitapawar/Dr Re--,TRANSFER FROM 4897732162091,,2221.48,54870.21
18 Aug 2024,TO TRANSFER-UPI/DR/448099607650/ROHIT T/SBIN/write2same/UPI--,TRANSFER TO 7382910045,4781.16,,50089.05
9 Aug 2024,BY TRANSFER-UPI/CR/412250830011/SAGAR MO/KKBK/rohit@okhdfc/Dr Re--,TRANSFER FROM 9137022807,,1297.45,51386.5
11 Jul 2024,TO TRANSFER-UPI/DR/401128875923/SAGAR MO/ICIC/write2same/UPI--,TRANSFER TO 4897690162095,1652.19,,49734.31
17 Jul 2024,TO TRANSFER-UPI/DR/496258519987/ANITA P/SBIN/write2same/UPI--,TRANSFER TO 4897732162091,4969.94,,44764.37
28 Aug 2024,BY TRANSFER-UPI/CR/427922520031/SAGAR MO/HDFC/anitapawar/Dr Re--,TRANSFER FROM 4897690162095,,4472.17,49236.54
12 Jul 2024,BY TRANSFER-UPI/CR/457643430871/ROHIT T/IDIB/rahuldixit/Dr Re--,TRANSFER FROM 9137022807,,1270.85,50507.39
21 Aug 2024,BY TRANSFER-UPI/CR/403534460163/PRIYA K/HDFC/rahuldixit/Dr Re--,TRANSFER FROM 8974521398,,2414.59,52921.98
8 Aug 2024,TO TRANSFER-UPI/DR/485876198769/MS SANJE/SBIN/spawar3290/UPI--,TRANSFER TO 4897732162091,1575.06,,51346.92
6 Jul 2024,TO TRANSFER-UPI/DR/491018212358/ANITA P/KKBK/write2same/UPI--,TRANSFER TO 7382910045,430.85,,50916.07
19 Sep 2024,TO TRANSFER-UPI/DR/475996488671/RAHUL D/HDFC/spawar3290/UPI--,TRANSFER TO 9137022807,2255.77,,48660.3
13 Sep 2024,BY TRANSFER-UPI/CR/420853832566/ANITA P/ICIC/rohit@okhdfc/Dr Re--,TRANSFER FROM 8974521398,,88.61,48748.91
22 Aug 2024,BY TRANSFER-UPI/CR/490283154614/SAMEER S/SBIN/anitapawar/Dr Re--,TRANSFER FROM 4897690162095,,187.13,48936.04
17 Aug 2024,TO TRANSFER-UPI/DR/480843224058/ROHIT T/SBIN/write2same/UPI--,TRANSFER TO 7382910045,1657.18,,47278.86
21 Sep 2024,BY TRANSFER-UPI/CR/461229220113/MS SANJE/KKBK/rohit@okhdfc/Dr Re--,TRANSFER FROM 8974521398,,2352.58,49631.44
21 Jul 2024,TO TRANSFER-UPI/DR/480294360221/ROHIT T/KKBK/rahuldixit/UPI--,TRANSFER TO 4897690162095,1483.15,,48148.29
25 Aug 2024,TO TRANSFER-UPI/DR/478644279607/PRIYA K/IDIB/rohit@okhdfc/UPI--,TRANSFER TO 7382910045,3695.18,,44453.11
26 Jul 2024,BY TRANSFER-UPI/CR/459245440528/SAMEER S/IDIB/rohit@okhdfc/Dr Re--,TRANSFER FROM 8974521398,,2568.57,47021.68
29 Jul 2024,BY TRANSFER-UPI/CR/403215459076/PRIYA K/KKBK/rohit@okhdfc/Dr Re--,TRANSFER FROM 7382910045,,2245.19,49266.87
19 Sep 2024,TO TRANSFER-UPI/DR/426550559607/SAMEER S/IDIB/write2same/UPI--,TRANSFER TO 9137022807,50.81,,49216.06
28 Jul 2024,BY TRANSFER-UPI/CR/445887869922/ROHIT T/IDIB/anitapawar/Dr Re--,TRANSFER FROM 4897690162095,,1721.33,50937.39
21 Sep 2024,BY TRANSFER-UPI/CR/436431543080/ROHIT T/KKBK/anitapawar/Dr Re--,TRANSFER FROM 8974521398,,579.78,51517.17
5 Jul 2024,TO TRANSFER-UPI/DR/451676453947/SAMEER S/ICIC/write2same/UPI--,TRANSFER TO 4897690162095,2956.68,,48560.49
4 Sep 2024,BY TRANSFER-UPI/CR/427926105616/SAGAR MO/IDIB/rahuldixit/Dr Re--,TRANSFER FROM 4897732162091,,2095.04,50655.53
6 Jul 2024,TO TRANSFER-UPI/DR/456420802845/ROHIT T/ICIC/rahuldixit/UPI--,TRANSFER TO 9137022807,1571.21,,49084.32
15 Jul 2024,BY TRANSFER-UPI/CR/481529910399/ROHIT T/IDIB/write2same/Dr Re--,TRANSFER FROM 8974521398,,488.97,49573.29
24 Jul 2024,BY TRANSFER-UPI/CR/489023206073/RAHUL D/HDFC/spawar3290/Dr Re--,TRANSFER FROM 9137022807,,1912.06,51485.35
29 Aug 2024,TO TRANSFER-UPI/DR/481147122013/SAGAR MO/HDFC/spawar3290/UPI--,TRANSFER TO 4897690162095,3460.31,,48025.04
3 Aug 2024,TO TRANSFER-UPI/DR/470752732130/MS SANJE/SBIN/rahuldixit/UPI--,TRANSFER TO 9137022807,327.74,,47697.3
26 Jul 2024,TO TRANSFER-UPI/DR/484082354451/ANITA P/SBIN/rahuldixit/UPI--,TRANSFER TO 4897732162091,2090.22,,45607.08
9 Aug 2024,BY TRANSFER-UPI/CR/408200326286/ROHIT T/HDFC/anitapawar/Dr Re--,TRANSFER FROM 8974521398,,778.39,46385.47
20 Aug 2024,BY TRANSFER-UPI/CR/426496767599/RAHUL D/HDFC/rahuldixit/Dr Re--,TRANSFER FROM 4897732162091,,4069.31,50454.78
2 Sep 2024,TO TRANSFER-UPI/DR/404192009365/ROHIT T/SBIN/rahuldixit/UPI--,TRANSFER TO 9137022807,4268.04,,46186.74
15 Jul 2024,TO TRANSFER-UPI/DR/418539670529/RAHUL D/SBIN/rahuldixit/UPI--,TRANSFER TO 4897732162091,1716.84,,44469.9
25 Aug 2024,TO TRANSFER-UPI/DR/485169140513/MS SANJE/KKBK/rohit@okhdfc/UPI--,TRANSFER TO 8974521398,866.52,,43603.38
10 Aug 2024,BY TRANSFER-UPI/CR/496644536866/RAHUL D/SBIN/rahuldixit/Dr Re--,TRANSFER FROM 7382910045,,362.06,43965.44
15 Sep 2024,BY TRANSFER-UPI/CR/454846315331/MS SANJE/SBIN/spawar3290/Dr Re--,TRANSFER FROM 8974521398,,3109.4,47074.84
12 Jul 2024,BY TRANSFER-UPI/CR/471153687604/SAMEER S/IDIB/spawar3290/Dr Re--,TRANSFER FROM 9137022807,,4463.08,51537.92
1 Jul 2024,BY TRANSFER-UPI/CR/407575175613/PRIYA K/IDIB/spawar3290/Dr Re--,TRANSFER FROM 8974521398,,2218.42,53756.34
18 Jul 2024,BY TRANSFER-UPI/CR/495901153558/PRIYA K/HDFC/anitapawar/Dr Re--,TRANSFER FROM 9137022807,,1541.67,55298.01
2 Jul 2024,BY TRANSFER-UPI/CR/422897589394/SAMEER S/SBIN/spawar3290/Dr Re--,TRANSFER FROM 8974521398,,1386.74,56684.75
18 Sep 2024,BY TRANSFER-UPI/CR/411872101571/SAGAR MO/IDIB/spawar3290/Dr Re--,TRANSFER FROM 7382910045,,3547.58,60232.33
5 Sep 2024,TO TRANSFER-UPI/DR/486507281129/SAMEER S/ICIC/spawar3290/UPI--,TRANSFER TO 9137022807,725.3,,59507.03
27 Sep 2024,BY TRANSFER-UPI/CR/440882606021/RAHUL D/IDIB/spawar3290/Dr Re--,TRANSFER FROM 4897690162095,,4568.83,64075.86
3 Sep 2024,TO TRANSFER-UPI/DR/418217241336/ROHIT T/ICIC/rahuldixit/UPI--,TRANSFER TO 9137022807,1289.87,,62785.99
1 Jul 2024,BY TRANSFER-UPI/CR/493632774796/SAMEER S/KKBK/spawar3290/Dr Re--,TRANSFER FROM 4897732162091,,53.46,62839.45
27 Jul 2024,BY TRANSFER-UPI/CR/404863750858/ROHIT T/HDFC/rahuldixit/Dr Re--,TRANSFER FROM 8974521398,,619.87,63459.32
14 Jul 2024,TO TRANSFER-UPI/DR/475082046998/PRIYA K/HDFC/rohit@okhdfc/UPI--,TRANSFER TO 4897732162091,4119.88,,59339.44
25 Aug 2024,BY TRANSFER-UPI/CR/476466519881/SAGAR MO/HDFC/spawar3290/Dr Re--,TRANSFER FROM 7382910045,,1930.21,61269.65
2 Aug 2024,TO TRANSFER-UPI/DR/439594160233/ROHIT T/HDFC/anitapawar/UPI--,TRANSFER TO 4897732162091,4223.93,,57045.72
28 Sep 2024,TO TRANSFER-UPI/DR/472411882571/SAGAR MO/ICIC/spawar3290/UPI--,TRANSFER TO 8974521398,1114.29,,55931.43
22 Aug 2024,BY TRANSFER-UPI/CR/448240164297/ANITA P/ICIC/spawar3290/Dr Re--,TRANSFER FROM 4897690162095,,2224.82,58156.25
13 Aug 2024,BY TRANSFER-UPI/CR/436887617000/PRIYA K/HDFC/write2same/Dr Re--,TRANSFER FROM 4897732162091,,4511.13,62667.38
13 Sep 2024,TO TRANSFER-UPI/DR/477539209234/MS SANJE/SBIN/anitapawar/UPI--,TRANSFER TO 4897732162091,4130.75,,58536.63
16 Aug 2024,BY TRANSFER-UPI/CR/440203813772/PRIYA K/SBIN/spawar3290/Dr Re--,TRANSFER FROM 7382910045,,4496.7,63033.33
21 Jul 2024,BY TRANSFER-UPI/CR/492155069067/RAHUL D/IDIB/rahuldixit/Dr Re--,TRANSFER FROM 8974521398,,3940.81,66974.14
21 Aug 2024,TO TRANSFER-UPI/DR/432427778157/SAGAR MO/KKBK/spawar3290/UPI--,TRANSFER TO 4897690162095,812.81,,66161.33
22 Jul 2024,BY TRANSFER-UPI/CR/480066057618/MS SANJE/IDIB/anitapawar/Dr Re--,TRANSFER FROM 7382910045,,4483.82,70645.15
13 Jul 2024,TO TRANSFER-UPI/DR/435467453305/SAMEER S/IDIB/anitapawar/UPI--,TRANSFER TO 9137022807,2614.23,,68030.92
20 Sep 2024,TO TRANSFER-UPI/DR/410519999537/SAGAR MO/SBIN/rahuldixit/UPI--,TRANSFER TO 9137022807,2625.72,,65405.2
11 Jul 2024,BY TRANSFER-UPI/CR/439926948212/PRIYA K/ICIC/rohit@okhdfc/Dr Re--,TRANSFER FROM 8974521398,,3607.8,69013.0
6 Jul 2024,BY TRANSFER-UPI/CR/414940723422/RAHUL D/IDIB/rahuldixit/Dr Re--,TRANSFER FROM 7382910045,,272.39,69285.39
21 Jul 2024,BY TRANSFER-UPI/CR/460267239146/SAMEER S/ICIC/anitapawar/Dr Re--,TRANSFER FROM 7382910045,,3603.98,72889.37
10 Jul 2024,TO TRANSFER-UPI/DR/420122229861/SAMEER S/KKBK/anitapawar/UPI--,TRANSFER TO 7382910045,4127.96,,68761.41
11 Aug 2024,TO TRANSFER-UPI/DR/433883944131/ANITA P/HDFC/rahuldixit/UPI--,TRANSFER TO 8974521398,4756.21,,64005.2
9 Sep 2024,BY TRANSFER-UPI/CR/465991732818/MS SANJE/HDFC/spawar3290/Dr Re--,TRANSFER FROM 7382910045,,608.91,64614.11
26 Sep 2024,TO TRANSFER-UPI/DR/419367134336/MS SANJE/KKBK/rohit@okhdfc/UPI--,TRANSFER TO 8974521398,1209.4,,63404.71
9 Sep 2024,BY TRANSFER-UPI/CR/425120005406/RAHUL D/IDIB/anitapawar/Dr Re--,TRANSFER FROM 7382910045,,3687.35,67092.06
14 Sep 2024,BY TRANSFER-UPI/CR/401504708519/ROHIT T/ICIC/write2same/Dr Re--,TRANSFER FROM 9137022807,,3775.72,70867.78
28 Aug 2024,BY TRANSFER-UPI/CR/444511238866/ANITA P/ICIC/rahuldixit/Dr Re--,TRANSFER FROM 8974521398,,2937.32,73805.1
16 Sep 2024,BY TRANSFER-UPI/CR/456972594789/ANITA P/ICIC/rahuldixit/Dr Re--,TRANSFER FROM 7382910045,,4796.76,78601.86
26 Sep 2024,BY TRANSFER-UPI/CR/451496114505/SAMEER S/ICIC/rahuldixit/Dr Re--,TRANSFER FROM 7382910045,,496.74,79098.6
3 Sep 2024,BY TRANSFER-UPI/CR/473399319223/SAGAR MO/KKBK/anitapawar/Dr Re--,TRANSFER FROM 4897690162095,,3754.57,82853.17
7 Sep 2024,TO TRANSFER-UPI/DR/436331097278/PRIYA K/ICIC/write2same/UPI--,TRANSFER TO 4897690162095,1277.23,,81575.94
29 Aug 2024,TO TRANSFER-UPI/DR/444171848443/SAMEER S/SBIN/rahuldixit/UPI--,TRANSFER TO 8974521398,3245.63,,78330.31
27 Sep 2024,BY TRANSFER-UPI/CR/438872975048/SAMEER S/KKBK/spawar3290/Dr Re--,TRANSFER FROM 4897690162095,,2431.09,80761.4
21 Jul 2024,TO TRANSFER-UPI/DR/405256187981/SAMEER S/IDIB/spawar3290/UPI--,TRANSFER TO 9137022807,1556.14,,79205.26
19 Jul 2024,TO TRANSFER-UPI/DR/437952889061/RAHUL D/ICIC/spawar3290/UPI--,TRANSFER TO 4897690162095,4143.45,,75061.81
28 Aug 2024,BY TRANSFER-UPI/CR/445537372635/MS SANJE/HDFC/rahuldixit/Dr Re--,TRANSFER FROM 7382910045,,3338.87,78400.68
29 Sep 2024,TO TRANSFER-UPI/DR/445009802207/PRIYA K/HDFC/spawar3290/UPI--,TRANSFER TO 9137022807,4514.45,,73886.23
15 Aug 2024,BY TRANSFER-UPI/CR/479604455899/MS SANJE/HDFC/write2same/Dr Re--,TRANSFER FROM 4897732162091,,4488.02,78374.25
27 Sep 2024,TO TRANSFER-UPI/DR/443756141373/MS SANJE/SBIN/anitapawar/UPI--,TRANSFER TO 9137022807,2648.34,,75725.91
11 Sep 2024,BY TRANSFER-UPI/CR/453603876815/ANITA P/IDIB/write2same/Dr Re--,TRANSFER FROM 9137022807,,3587.71,79313.62
26 Sep 2024,TO TRANSFER-UPI/DR/481175968144/MS SANJE/ICIC/write2same/UPI--,TRANSFER TO 7382910045,3948.67,,75364.95
2 Sep 2024,BY TRANSFER-UPI/CR/423245809924/MS SANJE/KKBK/anitapawar/Dr Re--,TRANSFER FROM 7382910045,,1684.51,77049.46
4 Sep 2024,BY TRANSFER-UPI/CR/418671566083/SAMEER S/IDIB/spawar3290/Dr Re--,TRANSFER FROM 7382910045,,1010.54,78060.0
26 Sep 2024,TO TRANSFER-UPI/DR/473201704176/ANITA P/IDIB/write2same/UPI--,TRANSFER TO 4897690162095,1375.79,,76684.21
21 Sep 2024,TO TRANSFER-UPI/DR/413916935578/MS SANJE/KKBK/write2same/UPI--,TRANSFER TO 9137022807,4056.14,,72628.07
14 Aug 2024,TO TRANSFER-UPI/DR/406942454121/SAGAR MO/IDIB/spawar3290/UPI--,TRANSFER TO 4897732162091,2295.6,,70332.47
12 Aug 2024,BY TRANSFER-UPI/CR/403521860849/RAHUL D/IDIB/rohit@okhdfc/Dr Re--,TRANSFER FROM 4897690162095,,3717.57,74050.04
21 Aug 2024,TO TRANSFER-UPI/DR/462371026109/RAHUL D/IDIB/rohit@okhdfc/UPI--,TRANSFER TO 8974521398,4588.86,,69461.18
4 Aug 2024,BY TRANSFER-UPI/CR/470596332686/ROHIT T/SBIN/rahuldixit/Dr Re--,TRANSFER FROM 4897732162091,,1085.79,70546.97
5 Jul 2024,TO TRANSFER-UPI/DR/479181451502/SAMEER S/KKBK/anitapawar/UPI--,TRANSFER TO 7382910045,3219.94,,67327.03
28 Jul 2024,BY TRANSFER-UPI/CR/448694128277/SAGAR MO/HDFC/rahuldixit/Dr Re--,TRANSFER FROM 9137022807,,3752.02,71079.05
13 Aug 2024,BY TRANSFER-UPI/CR/435144358384/ROHIT T/SBIN/anitapawar/Dr Re--,TRANSFER FROM 9137022807,,1335.74,72414.79
24 Sep 2024,BY TRANSFER-UPI/CR/499384647942/PRIYA K/KKBK/write2same/Dr Re--,TRANSFER FROM 8974521398,,1273.29,73688.08
25 Aug 2024,TO TRANSFER-UPI/DR/471358076182/RAHUL D/IDIB/spawar3290/UPI--,TRANSFER TO 8974521398,1151.6,,72536.48
21 Aug 2024,TO TRANSFER-UPI/DR/469882072331/SAMEER S/ICIC/rohit@okhdfc/UPI--,TRANSFER TO 9137022807,1042.02,,71494.46
31 Jul 2024,BY TRANSFER-UPI/CR/431284145594/ANITA P/ICIC/rohit@okhdfc/Dr Re--,TRANSFER FROM 7382910045,,1872.11,73366.57
6 Aug 2024,BY TRANSFER-UPI/CR/453095670236/ROHIT T/KKBK/rohit@okhdfc/Dr Re--,TRANSFER FROM 8974521398,,2848.3,76214.87
28 Sep 2024,BY TRANSFER-UPI/CR/424484520955/SAGAR MO/SBIN/write2same/Dr Re--,TRANSFER FROM 8974521398,,3092.83,79307.7
22 Aug 2024,TO TRANSFER-UPI/DR/498899268525/MS SANJE/IDIB/rohit@okhdfc/UPI--,TRANSFER TO 4897732162091,3633.18,,75674.52
19 Aug 2024,TO TRANSFER-UPI/DR/430292392433/RAHUL D/KKBK/rahuldixit/UPI--,TRANSFER TO 4897690162095,4999.83,,70674.69
12 Sep 2024,TO TRANSFER-UPI/DR/472075221318/SAMEER S/IDIB/spawar3290/UPI--,TRANSFER TO 4897690162095,3715.5,,66959.19
2 Aug 2024,BY TRANSFER-UPI/CR/479292123493/ANITA P/ICIC/anitapawar/Dr Re--,TRANSFER FROM 4897690162095,,1464.66,68423.85
21 Aug 2024,TO TRANSFER-UPI/DR/434739091163/SAGAR MO/SBIN/rohit@okhdfc/UPI--,TRANSFER TO 7382910045,2633.32,,65790.53
1 Jul 2024,BY TRANSFER-UPI/CR/469717806315/SAMEER S/IDIB/rohit@okhdfc/Dr Re--,TRANSFER FROM 9137022807,,3591.1,69381.63
14 Aug 2024,BY TRANSFER-UPI/CR/491786556932/ROHIT T/KKBK/anitapawar/Dr Re--,TRANSFER FROM 4897690162095,,458.19,69839.82
13 Sep 2024,BY TRANSFER-UPI/CR/481187536606/PRIYA K/KKBK/rahuldixit/Dr Re--,TRANSFER FROM 4897732162091,,1746.25,71586.07
14 Jul 2024,BY TRANSFER-UPI/CR/442523971097/RAHUL D/IDIB/anitapawar/Dr Re--,TRANSFER FROM 4897690162095,,2514.9,74100.97
18 Jul 2024,TO TRANSFER-UPI/DR/468304535334/ANITA P/SBIN/write2same/UPI--,TRANSFER TO 7382910045,1762.83,,72338.14
30 Jul 2024,TO TRANSFER-UPI/DR/438748735266/SAMEER S/HDFC/rohit@okhdfc/UPI--,TRANSFER TO 7382910045,2231.46,,70106.68
26 Jul 2024,BY TRANSFER-UPI/CR/423619618553/ANITA P/KKBK/rahuldixit/Dr Re--,TRANSFER FROM 4897690162095,,4878.74,74985.42
23 Sep 2024,TO TRANSFER-UPI/DR/443352440452/ROHIT T/KKBK/rahuldixit/UPI--,TRANSFER TO 4897690162095,3100.93,,71884.49
21 Aug 2024,BY TRANSFER-UPI/CR/466083828172/ANITA P/HDFC/write2same/Dr Re--,TRANSFER FROM 4897732162091,,2500.25,74384.74
29 Sep 2024,BY TRANSFER-UPI/CR/401499725638/ANITA P/IDIB/rahuldixit/Dr Re--,TRANSFER FROM 4897690162095,,4814.86,79199.6
1 Jul 2024,BY TRANSFER-UPI/CR/486529085147/SAGAR MO/SBIN/spawar3290/Dr Re--,TRANSFER FROM 8974521398,,3642.49,82842.09
23 Aug 2024,BY TRANSFER-UPI/CR/461049857634/MS SANJE/IDIB/anitapawar/Dr Re--,TRANSFER FROM 4897732162091,,3866.38,86708.47
25 Jul 2024,TO TRANSFER-UPI/DR/487165233599/ANITA P/SBIN/spawar3290/UPI--,TRANSFER TO 4897732162091,704.24,,86004.23
4 Aug 2024,TO TRANSFER-UPI/DR/459565856844/ANITA P/KKBK/anitapawar/UPI--,TRANSFER TO 8974521398,3267.6,,82736.63
4 Jul 2024,BY TRANSFER-UPI/CR/459732534737/RAHUL D/KKBK/spawar3290/Dr Re--,TRANSFER FROM 4897690162095,,4101.74,86838.37
18 Aug 2024,TO TRANSFER-UPI/DR/487626489982/RAHUL D/IDIB/anitapawar/UPI--,TRANSFER TO 4897690162095,293.8,,86544.57
3 Sep 2024,BY TRANSFER-UPI/CR/473965129988/RAHUL D/SBIN/write2same/Dr Re--,TRANSFER FROM 4897690162095,,1134.85,87679.42
15 Aug 2024,TO TRANSFER-UPI/DR/434599550646/PRIYA K/HDFC/anitapawar/UPI--,TRANSFER TO 4897690162095,1289.94,,86389.48
28 Jul 2024,BY TRANSFER-UPI/CR/497156710695/ANITA P/ICIC/anitapawar/Dr Re--,TRANSFER FROM 8974521398,,583.57,86973.05
27 Aug 2024,TO TRANSFER-UPI/DR/481904653936/MS SANJE/SBIN/rohit@okhdfc/UPI--,TRANSFER TO 4897690162095,2608.4,,84364.65
15 Jul 2024,TO TRANSFER-UPI/DR/408311805425/ROHIT T/SBIN/anitapawar/UPI--,TRANSFER TO 4897732162091,3567.84,,80796.81
13 Aug 2024,BY TRANSFER-UPI/CR/465262553209/ANITA P/KKBK/rahuldixit/Dr Re--,TRANSFER FROM 4897690162095,,1716.58,82513.39
10 Jul 2024,BY TRANSFER-UPI/CR/472914263492/PRIYA K/KKBK/write2same/Dr Re--,TRANSFER FROM 8974521398,,2305.65,84819.04
22 Aug 2024,TO TRANSFER-UPI/DR/426033325395/SAMEER S/HDFC/rohit@okhdfc/UPI--,TRANSFER TO 4897732162091,2473.2,,82345.84
29 Sep 2024,TO TRANSFER-UPI/DR/488860326307/MS SANJE/KKBK/rohit@okhdfc/UPI--,TRANSFER TO 8974521398,1095.07,,81250.77
18 Jul 2024,BY TRANSFER-UPI/CR/407226762468/SAMEER S/SBIN/spawar3290/Dr Re--,TRANSFER FROM 4897732162091,,798.3,82049.07
15 Sep 2024,BY TRANSFER-UPI/CR/423880039569/ROHIT T/SBIN/rohit@okhdfc/Dr Re--,TRANSFER FROM 7382910045,,483.02,82532.09
18 Jul 2024,TO TRANSFER-UPI/DR/470776882344/SAGAR MO/SBIN/spawar3290/UPI--,TRANSFER TO 9137022807,2519.48,,80012.61
31 Jul 2024,TO TRANSFER-UPI/DR/478883945394/PRIYA K/HDFC/rohit@okhdfc/UPI--,TRANSFER TO 4897690162095,3557.15,,76455.46
12 Aug 2024,TO TRANSFER-UPI/DR/415819001897/SAGAR MO/HDFC/rahuldixit/UPI--,TRANSFER TO 8974521398,4707.52,,71747.94
2 Aug 2024,BY TRANSFER-UPI/CR/411214972061/PRIYA K/ICIC/write2same/Dr Re--,TRANSFER FROM 7382910045,,4024.4,75772.34
28 Aug 2024,BY TRANSFER-UPI/CR/451472675004/MS SANJE/HDFC/anitapawar/Dr Re--,TRANSFER FROM 7382910045,,2567.35,78339.69
16 Jul 2024,TO TRANSFER-UPI/DR/477974341241/ROHIT T/HDFC/spawar3290/UPI--,TRANSFER TO 8974521398,572.62,,77767.07
13 Sep 2024,TO TRANSFER-UPI/DR/449769782221/MS SANJE/IDIB/write2same/UPI--,TRANSFER TO 7382910045,80.5,,77686.57
16 Sep 2024,TO TRANSFER-UPI/DR/402441610614/ROHIT T/HDFC/rahuldixit/UPI--,TRANSFER TO 9137022807,4778.96,,72907.61
1 Jul 2024,TO TRANSFER-UPI/DR/478803803347/MS SANJE/KKBK/spawar3290/UPI--,TRANSFER TO 4897732162091,3789.77,,69117.84
2 Aug 2024,BY TRANSFER-UPI/CR/402231886437/MS SANJE/HDFC/spawar3290/Dr Re--,TRANSFER FROM 4897690162095,,2561.34,71679.18
20 Jul 2024,TO TRANSFER-UPI/DR/476859497104/MS SANJE/HDFC/anitapawar/UPI--,TRANSFER TO 9137022807,4113.72,,67565.46
13 Aug 2024,TO TRANSFER-UPI/DR/406542310748/ROHIT T/SBIN/rahuldixit/UPI--,TRANSFER TO 4897690162095,4486.6,,63078.86
27 Jul 2024,BY TRANSFER-UPI/CR/448555307083/ROHIT T/HDFC/anitapawar/Dr Re--,TRANSFER FROM 8974521398,,1520.65,64599.51
8 Aug 2024,TO TRANSFER-UPI/DR/435390577683/ROHIT T/ICIC/anitapawar/UPI--,TRANSFER TO 8974521398,4468.09,,60131.42
26 Aug 2024,BY TRANSFER-UPI/CR/476726897387/RAHUL D/SBIN/rahuldixit/Dr Re--,TRANSFER FROM 9137022807,,2938.79,63070.21
9 Sep 2024,BY TRANSFER-UPI/CR/423007776042/SAMEER S/ICIC/write2same/Dr Re--,TRANSFER FROM 4897732162091,,4576.98,67647.19
11 Sep 2024,BY TRANSFER-UPI/CR/498341669539/ANITA P/KKBK/spawar3290/Dr Re--,TRANSFER FROM 7382910045,,2983.82,70631.01
11 Aug 2024,BY TRANSFER-UPI/CR/488070277229/RAHUL D/ICIC/rohit@okhdfc/Dr Re--,TRANSFER FROM 4897732162091,,4617.64,75248.65
26 Sep 2024,TO TRANSFER-UPI/DR/430457431836/ANITA P/ICIC/anitapawar/UPI--,TRANSFER TO 8974521398,1641.07,,73607.58
24 Aug 2024,TO TRANSFER-UPI/DR/448066030090/SAGAR MO/SBIN/rahuldixit/UPI--,TRANSFER TO 7382910045,102.71,,73504.87
14 Sep 2024,TO TRANSFER-UPI/DR/474721097901/PRIYA K/SBIN/anitapawar/UPI--,TRANSFER TO 9137022807,1446.24,,72058.63
15 Aug 2024,TO TRANSFER-UPI/DR/401408993401/ROHIT T/SBIN/anitapawar/UPI--,TRANSFER TO 9137022807,4127.95,,67930.68
1 Jul 2024,TO TRANSFER-UPI/DR/498608200414/RAHUL D/KKBK/write2same/UPI--,TRANSFER TO 7382910045,4840.69,,63089.99
8 Sep 2024,TO TRANSFER-UPI/DR/407056600377/SAGAR MO/SBIN/write2same/UPI--,TRANSFER TO 9137022807,3620.44,,59469.55
4 Sep 2024,BY TRANSFER-UPI/CR/482988320328/PRIYA K/KKBK/rohit@okhdfc/Dr Re--,TRANSFER FROM 4897732162091,,3762.32,63231.87
8 Jul 2024,TO TRANSFER-UPI/DR/436414847752/SAMEER S/SBIN/spawar3290/UPI--,TRANSFER TO 8974521398,2527.73,,60704.14
3 Jul 2024,BY TRANSFER-UPI/CR/440882124177/ANITA P/SBIN/write2same/Dr Re--,TRANSFER FROM 9137022807,,1920.31,62624.45
13 Sep 2024,TO TRANSFER-UPI/DR/440226657287/MS SANJE/ICIC/anitapawar/UPI--,TRANSFER TO 7382910045,3884.14,,58740.31
27 Jul 2024,TO TRANSFER-UPI/DR/465449409850/MS SANJE/SBIN/write2same/UPI--,TRANSFER TO 8974521398,785.55,,57954.76
23 Sep 2024,BY TRANSFER-UPI/CR/458840147379/ROHIT T/IDIB/anitapawar/Dr Re--,TRANSFER FROM 7382910045,,775.55,58730.31
29 Jul 2024,TO TRANSFER-UPI/DR/416742522249/SAMEER S/KKBK/anitapawar/UPI--,TRANSFER TO 9137022807,3497.59,,55232.72
26 Aug 2024,BY TRANSFER-UPI/CR/406623237381/ANITA P/KKBK/write2same/Dr Re--,TRANSFER FROM 7382910045,,3632.18,58864.9
21 Aug 2024,TO TRANSFER-UPI/DR/462369215538/ANITA P/SBIN/rohit@okhdfc/UPI--,TRANSFER TO 8974521398,3264.0,,55600.9
21 Aug 2024,TO TRANSFER-UPI/DR/418447226894/MS SANJE/IDIB/rohit@okhdfc/UPI--,TRANSFER TO 7382910045,1026.37,,54574.53
8 Jul 2024,TO TRANSFER-UPI/DR/427858761612/PRIYA K/SBIN/rohit@okhdfc/UPI--,TRANSFER TO 9137022807,1017.67,,53556.86
24 Jul 2024,TO TRANSFER-UPI/DR/479351774871/SAGAR MO/HDFC/spawar3290/UPI--,TRANSFER TO 7382910045,3569.69,,49987.17
25 Aug 2024,BY TRANSFER-UPI/CR/439112896633/PRIYA K/HDFC/rohit@okhdfc/Dr Re--,TRANSFER FROM 4897732162091,,908.41,50895.58
18 Aug 2024,BY TRANSFER-UPI/CR/487401883056/ROHIT T/IDIB/rahuldixit/Dr Re--,TRANSFER FROM 9137022807,,4580.6,55476.18
23 Sep 2024,TO TRANSFER-UPI/DR/434407528657/MS SANJE/ICIC/rahuldixit/UPI--,TRANSFER TO 7382910045,1055.79,,54420.39
18 Jul 2024,TO TRANSFER-UPI/DR/477864503728/MS SANJE/ICIC/rahuldixit/UPI--,TRANSFER TO 7382910045,841.0,,53579.39
19 Aug 2024,TO TRANSFER-UPI/DR/482373471642/ROHIT T/KKBK/spawar3290/UPI--,TRANSFER TO 9137022807,671.29,,52908.1
27 Aug 2024,TO TRANSFER-UPI/DR/404888628243/MS SANJE/KKBK/rahuldixit/UPI--,TRANSFER TO 9137022807,4304.23,,48603.87
16 Aug 2024,BY TRANSFER-UPI/CR/435509572357/RAHUL D/HDFC/spawar3290/Dr Re--,TRANSFER FROM 4897732162091,,1551.94,50155.81
26 Jul 2024,TO TRANSFER-UPI/DR/474255727262/SAGAR MO/HDFC/spawar3290/UPI--,TRANSFER TO 4897732162091,3583.15,,46572.66
28 Jul 2024,BY TRANSFER-UPI/CR/467415346907/ANITA P/HDFC/write2same/Dr Re--,TRANSFER FROM 9137022807,,898.22,47470.88
30 Aug 2024,TO TRANSFER-UPI/DR/417298300290/PRIYA K/ICIC/anitapawar/UPI--,TRANSFER TO 8974521398,1229.17,,46241.71
19 Aug 2024,BY TRANSFER-UPI/CR/486279593173/RAHUL D/SBIN/write2same/Dr Re--,TRANSFER FROM 8974521398,,87.2,46328.91
14 Aug 2024,TO TRANSFER-UPI/DR/486795378084/RAHUL D/HDFC/rahuldixit/UPI--,TRANSFER TO 7382910045,2768.52,,43560.39
22 Aug 2024,TO TRANSFER-UPI/DR/455508349075/ANITA P/HDFC/write2same/UPI--,TRANSFER TO 7382910045,3172.43,,40387.96
17 Aug 2024,BY TRANSFER-UPI/CR/427682090140/ROHIT T/IDIB/write2same/Dr Re--,TRANSFER FROM 8974521398,,1994.75,42382.71
16 Sep 2024,TO TRANSFER-UPI/DR/426619292136/MS SANJE/SBIN/write2same/UPI--,TRANSFER TO 7382910045,1793.73,,40588.98
30 Aug 2024,BY TRANSFER-UPI/CR/476084833159/MS SANJE/SBIN/spawar3290/Dr Re--,TRANSFER FROM 9137022807,,1011.88,41600.86
26 Jul 2024,TO TRANSFER-UPI/DR/496279785312/MS SANJE/KKBK/write2same/UPI--,TRANSFER TO 4897690162095,216.35,,41384.51
9 Sep 2024,TO TRANSFER-UPI/DR/475762420772/ANITA P/IDIB/rahuldixit/UPI--,TRANSFER TO 4897690162095,2565.15,,38819.36
13 Aug 2024,BY TRANSFER-UPI/CR/432730821958/SAMEER S/KKBK/write2same/Dr Re--,TRANSFER FROM 7382910045,,4890.46,43709.82
29 Jul 2024,BY TRANSFER-UPI/CR/495920453865/PRIYA K/HDFC/spawar3290/Dr Re--,TRANSFER FROM 7382910045,,4287.15,47996.97
18 Jul 2024,TO TRANSFER-UPI/DR/473883168408/PRIYA K/SBIN/spawar3290/UPI--,TRANSFER TO 9137022807,2597.42,,45399.55
26 Aug 2024,TO TRANSFER-UPI/DR/457451403371/PRIYA K/HDFC/rohit@okhdfc/UPI--,TRANSFER TO 7382910045,1842.84,,43556.71
2 Jul 2024,TO TRANSFER-UPI/DR/495550125557/ANITA P/SBIN/rohit@okhdfc/UPI--,TRANSFER TO 9137022807,987.33,,42569.38
18 Aug 2024,BY TRANSFER-UPI/CR/426434898615/ROHIT T/HDFC/anitapawar/Dr Re--,TRANSFER FROM 7382910045,,1191.73,43761.11
29 Sep 2024,TO TRANSFER-UPI/DR/400956716605/MS SANJE/IDIB/spawar3290/UPI--,TRANSFER TO 4897690162095,2847.62,,40913.49
8 Sep 2024,BY TRANSFER-UPI/CR/435607316076/RAHUL D/IDIB/rahuldixit/Dr Re--,TRANSFER FROM 4897690162095,,3236.22,44149.71
26 Jul 2024,BY TRANSFER-UPI/CR/464484872163/SAMEER S/IDIB/write2same/Dr Re--,TRANSFER FROM 8974521398,,2071.77,46221.48
7 Sep 2024,TO TRANSFER-UPI/DR/494708936172/SAGAR MO/IDIB/write2same/UPI--,TRANSFER TO 8974521398,1089.71,,45131.77
29 Jul 2024,BY TRANSFER-UPI/CR/425652026160/SAGAR MO/KKBK/write2same/Dr Re--,TRANSFER FROM 4897732162091,,618.52,45750.29
29 Jul 2024,TO TRANSFER-UPI/DR/454075372167/RAHUL D/ICIC/rahuldixit/UPI--,TRANSFER TO 8974521398,1575.12,,44175.17
31 Jul 2024,BY TRANSFER-UPI/CR/419013808110/SAGAR MO/SBIN/write2same/Dr Re--,TRANSFER FROM 8974521398,,2927.53,47102.7
30 Jul 2024,BY TRANSFER-UPI/CR/439455614264/MS SANJE/KKBK/spawar3290/Dr Re--,TRANSFER FROM 7382910045,,4300.43,51403.13
8 Jul 2024,TO TRANSFER-UPI/DR/429168998175/MS SANJE/HDFC/rohit@okhdfc/UPI--,TRANSFER TO 8974521398,1906.13,,49497.0
18 Aug 2024,TO TRANSFER-UPI/DR/422116125313/SAGAR MO/IDIB/write2same/UPI--,TRANSFER TO 4897732162091,1927.5,,47569.5
15 Aug 2024,TO TRANSFER-UPI/DR/483997055754/SAMEER S/HDFC/rohit@okhdfc/UPI--,TRANSFER TO 8974521398,4379.29,,43190.21
20 Aug 2024,BY TRANSFER-UPI/CR/415091207826/SAGAR MO/SBIN/write2same/Dr Re--,TRANSFER FROM 7382910045,,297.84,43488.05
30 Aug 2024,TO TRANSFER-UPI/DR/495001336371/ANITA P/ICIC/spawar3290/UPI--,TRANSFER TO 4897732162091,3960.57,,39527.48
15 Sep 2024,BY TRANSFER-UPI/CR/493205220053/SAMEER S/SBIN/anitapawar/Dr Re--,TRANSFER FROM 4897690162095,,1676.08,41203.56
26 Aug 2024,TO TRANSFER-UPI/DR/447127268546/SAMEER S/KKBK/anitapawar/UPI--,TRANSFER TO 4897690162095,4059.08,,37144.48
30 Jul 2024,BY TRANSFER-UPI/CR/420620759405/RAHUL D/ICIC/spawar3290/Dr Re--,TRANSFER FROM 8974521398,,2858.23,40002.71
11 Jul 2024,TO TRANSFER-UPI/DR/487325224116/ANITA P/ICIC/anitapawar/UPI--,TRANSFER TO 4897690162095,4262.61,,35740.1
23 Sep 2024,TO TRANSFER-UPI/DR/409759143478/SAGAR MO/IDIB/anitapawar/UPI--,TRANSFER TO 7382910045,4693.97,,31046.13
24 Aug 2024,BY TRANSFER-UPI/CR/447083725251/SAGAR MO/SBIN/anitapawar/Dr Re--,TRANSFER FROM 4897690162095,,4007.13,35053.26
29 Jul 2024,BY TRANSFER-UPI/CR/413740725161/ROHIT T/KKBK/spawar3290/Dr Re--,TRANSFER FROM 4897690162095,,3921.8,38975.06
22 Sep 2024,TO TRANSFER-UPI/DR/409943224625/ROHIT T/IDIB/spawar3290/UPI--,TRANSFER TO 8974521398,1069.42,,37905.64
5 Jul 2024,BY TRANSFER-UPI/CR/425691471986/SAGAR MO/HDFC/anitapawar/Dr Re--,TRANSFER FROM 8974521398,,916.25,38821.89
9 Sep 2024,TO TRANSFER-UPI/DR/469753103410/RAHUL D/ICIC/anitapawar/UPI--,TRANSFER TO 7382910045,4062.7,,34759.19
27 Sep 2024,BY TRANSFER-UPI/CR/477457414966/SAGAR MO/ICIC/spawar3290/Dr Re--,TRANSFER FROM 7382910045,,3656.1,38415.29
13 Aug 2024,TO TRANSFER-UPI/DR/429916985027/SAMEER S/HDFC/anitapawar/UPI--,TRANSFER TO 7382910045,704.87,,37710.42
12 Sep 2024,BY TRANSFER-UPI/CR/448769225703/ROHIT T/IDIB/rohit@okhdfc/Dr Re--,TRANSFER FROM 7382910045,,556.49,38266.91
6 Jul 2024,TO TRANSFER-UPI/DR/420727201387/PRIYA K/IDIB/rahuldixit/UPI--,TRANSFER TO 8974521398,860.32,,37406.59
1 Sep 2024,TO TRANSFER-UPI/DR/473441708099/RAHUL D/ICIC/spawar3290/UPI--,TRANSFER TO 8974521398,4295.02,,33111.57
22 Sep 2024,BY TRANSFER-UPI/CR/465730136733/ANITA P/ICIC/rohit@okhdfc/Dr Re--,TRANSFER FROM 4897690162095,,2599.5,35711.07
30 Jul 2024,TO TRANSFER-UPI/DR/460617414841/RAHUL D/SBIN/rohit@okhdfc/UPI--,TRANSFER TO 4897690162095,4988.36,,30722.71
12 Aug 2024,BY TRANSFER-UPI/CR/488906929365/SAMEER S/HDFC/spawar3290/Dr Re--,TRANSFER FROM 9137022807,,4036.04,34758.75
18 Jul 2024,TO TRANSFER-UPI/DR/445312638216/MS SANJE/SBIN/write2same/UPI--,TRANSFER TO 4897732162091,3211.69,,31547.06
3 Sep 2024,TO TRANSFER-UPI/DR/439240638372/ANITA P/IDIB/spawar3290/UPI--,TRANSFER TO 4897732162091,2835.61,,28711.45
13 Aug 2024,TO TRANSFER-UPI/DR/417317118683/SAMEER S/ICIC/anitapawar/UPI--,TRANSFER TO 4897690162095,293.36,,28418.09
24 Aug 2024,BY TRANSFER-UPI/CR/446433143833/PRIYA K/KKBK/write2same/Dr Re--,TRANSFER FROM 4897732162091,,3895.78,32313.87
28 Sep 2024,TO TRANSFER-UPI/DR/425109665730/ANITA P/KKBK/spawar3290/UPI--,TRANSFER TO 7382910045,4855.4,,27458.47
29 Jul 2024,BY TRANSFER-UPI/CR/452878358445/RAHUL D/ICIC/rahuldixit/Dr Re--,TRANSFER FROM 4897690162095,,2516.87,29975.34
2 Jul 2024,BY TRANSFER-UPI/CR/447011988534/SAGAR MO/IDIB/spawar3290/Dr Re--,TRANSFER FROM 8974521398,,1665.26,31640.6
17 Jul 2024,BY TRANSFER-UPI/CR/468310147666/MS SANJE/HDFC/rohit@okhdfc/Dr Re--,TRANSFER FROM 4897690162095,,700.63,32341.23
22 Jul 2024,TO TRANSFER-UPI/DR/441441437917/RAHUL D/IDIB/rahuldixit/UPI--,TRANSFER TO 4897690162095,1936.32,,30404.91
17 Sep 2024,BY TRANSFER-UPI/CR/451440657950/SAMEER S/IDIB/spawar3290/Dr Re--,TRANSFER FROM 8974521398,,1970.42,32375.33
30 Aug 2024,TO TRANSFER-UPI/DR/487947630058/ROHIT T/IDIB/anitapawar/UPI--,TRANSFER TO 7382910045,3498.89,,28876.44
12 Jul 2024,TO TRANSFER-UPI/DR/438973313309/MS SANJE/SBIN/anitapawar/UPI--,TRANSFER TO 7382910045,3717.34,,25159.1
4 Jul 2024,TO TRANSFER-UPI/DR/456796316052/SAMEER S/HDFC/anitapawar/UPI--,TRANSFER TO 8974521398,4946.45,,20212.65
20 Sep 2024,TO TRANSFER-UPI/DR/483490677603/ROHIT T/KKBK/write2same/UPI--,TRANSFER TO 4897690162095,110.06,,20102.59
6 Sep 2024,TO TRANSFER-UPI/DR/451244289517/SAMEER S/KKBK/anitapawar/UPI--,TRANSFER TO 9137022807,1013.92,,19088.67
7 Jul 2024,TO TRANSFER-UPI/DR/453548501672/ANITA P/ICIC/anitapawar/UPI--,TRANSFER TO 7382910045,767.3,,18321.37
3 Sep 2024,TO TRANSFER-UPI/DR/430561359818/RAHUL D/IDIB/rahuldixit/UPI--,TRANSFER TO 4897732162091,2215.71,,16105.66
3 Jul 2024,TO TRANSFER-UPI/DR/495186676444/ANITA P/ICIC/anitapawar/UPI--,TRANSFER TO 4897732162091,69.6,,16036.06
21 Jul 2024,TO TRANSFER-UPI/DR/422375166201/MS SANJE/ICIC/spawar3290/UPI--,TRANSFER TO 9137022807,2765.67,,13270.39
26 Jul 2024,TO TRANSFER-UPI/DR/472012353395/RAHUL D/KKBK/spawar3290/UPI--,TRANSFER TO 4897690162095,3596.11,,9674.28
18 Aug 2024,TO TRANSFER-UPI/DR/417733063036/SAMEER S/IDIB/rahuldixit/UPI--,TRANSFER TO 7382910045,663.46,,9010.82
13 Jul 2024,BY TRANSFER-UPI/CR/414987158805/SAMEER S/ICIC/spawar3290/Dr Re--,TRANSFER FROM 8974521398,,3728.7,12739.52
8 Aug 2024,TO TRANSFER-UPI/DR/474257645791/SAGAR MO/SBIN/rohit@okhdfc/UPI--,TRANSFER TO 9137022807,3979.83,,8759.69
30 Aug 2024,TO TRANSFER-UPI/DR/463196132800/MS SANJE/KKBK/rahuldixit/UPI--,TRANSFER TO 9137022807,3095.57,,5664.12
7 Sep 2024,TO TRANSFER-UPI/DR/407359874597/SAGAR MO/IDIB/spawar3290/UPI--,TRANSFER TO 8974521398,4242.53,,1421.59
19 Sep 2024,TO TRANSFER-UPI/DR/499020975991/ANITA P/ICIC/anitapawar/UPI--,TRANSFER TO 7382910045,4108.94,,-2687.35
13 Sep 2024,TO TRANSFER-UPI/DR/459719462461/ANITA P/IDIB/write2same/UPI--,TRANSFER TO 8974521398,2114.64,,-4801.99
28 Aug 2024,BY TRANSFER-UPI/CR/454496981128/SAGAR MO/SBIN/anitapawar/Dr Re--,TRANSFER FROM 4897690162095,,1126.71,-3675.28
13 Sep 2024,BY TRANSFER-UPI/CR/487261585121/SAMEER S/KKBK/spawar3290/Dr Re--,TRANSFER FROM 4897690162095,,4211.1,535.82
31 Aug 2024,BY TRANSFER-UPI/CR/450886440061/SAMEER S/KKBK/write2same/Dr Re--,TRANSFER FROM 4897732162091,,734.67,1270.49
1 Jul 2024,BY TRANSFER-UPI/CR/412030169922/ROHIT T/ICIC/rohit@okhdfc/Dr Re--,TRANSFER FROM 8974521398,,2279.74,3550.23
7 Jul 2024,TO TRANSFER-UPI/DR/488615177778/ROHIT T/HDFC/write2same/UPI--,TRANSFER TO 9137022807,738.59,,2811.64
3 Aug 2024,BY TRANSFER-UPI/CR/477201864361/ANITA P/KKBK/anitapawar/Dr Re--,TRANSFER FROM 9137022807,,914.38,3726.02
3 Jul 2024,BY TRANSFER-UPI/CR/437477217653/RAHUL D/ICIC/write2same/Dr Re--,TRANSFER FROM 8974521398,,1346.46,5072.48
28 Jul 2024,TO TRANSFER-UPI/DR/494681438947/SAMEER S/IDIB/rohit@okhdfc/UPI--,TRANSFER TO 4897732162091,3897.88,,1174.6
20 Sep 2024,TO TRANSFER-UPI/DR/431434433019/ROHIT T/ICIC/spawar3290/UPI--,TRANSFER TO 9137022807,3759.68,,-2585.08
29 Jul 2024,TO TRANSFER-UPI/DR/489720005307/RAHUL D/KKBK/spawar3290/UPI--,TRANSFER TO 4897690162095,2802.81,,-5387.89
8 Jul 2024,TO TRANSFER-UPI/DR/490495020172/RAHUL D/SBIN/write2same/UPI--,TRANSFER TO 7382910045,1965.32,,-7353.21
26 Aug 2024,TO TRANSFER-UPI/DR/475333658713/SAMEER S/SBIN/rohit@okhdfc/UPI--,TRANSFER TO 8974521398,3817.69,,-11170.9
5 Sep 2024,BY TRANSFER-UPI/CR/477734494943/ROHIT T/HDFC/rahuldixit/Dr Re--,TRANSFER FROM 9137022807,,4411.66,-6759.24
27 Jul 2024,TO TRANSFER-UPI/DR/404997666592/SAGAR MO/ICIC/anitapawar/UPI--,TRANSFER TO 7382910045,1996.84,,-8756.08
18 Sep 2024,TO TRANSFER-UPI/DR/442434871956/SAGAR MO/ICIC/rahuldixit/UPI--,TRANSFER TO 4897690162095,2346.93,,-11103.01
13 Aug 2024,BY TRANSFER-UPI/CR/463865757784/RAHUL D/KKBK/spawar3290/Dr Re--,TRANSFER FROM 7382910045,,3748.98,-7354.03
12 Aug 2024,TO TRANSFER-UPI/DR/454952775240/RAHUL D/SBIN/anitapawar/UPI--,TRANSFER TO 4897690162095,2976.14,,-10330.17
20 Sep 2024,BY TRANSFER-UPI/CR/489337233512/PRIYA K/ICIC/rahuldixit/Dr Re--,TRANSFER FROM 9137022807,,416.65,-9913.52
2 Sep 2024,BY TRANSFER-UPI/CR/453716639231/MS SANJE/SBIN/anitapawar/Dr Re--,TRANSFER FROM 9137022807,,2363.31,-7550.21
24 Jul 2024,TO TRANSFER-UPI/DR/404813144671/PRIYA K/HDFC/spawar3290/UPI--,TRANSFER TO 4897732162091,2969.36,,-10519.57
21 Jul 2024,BY TRANSFER-UPI/CR/447650743886/SAGAR MO/KKBK/write2same/Dr Re--,TRANSFER FROM 7382910045,,1210.04,-9309.53
14 Aug 2024,BY TRANSFER-UPI/CR/451949349090/SAMEER S/IDIB/write2same/Dr Re--,TRANSFER FROM 9137022807,,864.71,-8444.82
31 Jul 2024,TO TRANSFER-UPI/DR/438191214819/SAMEER S/SBIN/rahuldixit/UPI--,TRANSFER TO 9137022807,1162.93,,-9607.75
13 Jul 2024,BY TRANSFER-UPI/CR/498710305041/RAHUL D/SBIN/anitapawar/Dr Re--,TRANSFER FROM 7382910045,,157.33,-9450.42
14 Sep 2024,TO TRANSFER-UPI/DR/401811192764/RAHUL D/HDFC/write2same/UPI--,TRANSFER TO 9137022807,2169.35,,-11619.77
25 Jul 2024,TO TRANSFER-UPI/DR/439430594813/SAMEER S/ICIC/rohit@okhdfc/UPI--,TRANSFER TO 7382910045,106.77,,-11726.54
9 Aug 2024,TO TRANSFER-UPI/DR/453682146152/SAMEER S/IDIB/rohit@okhdfc/UPI--,TRANSFER TO 4897732162091,3410.32,,-15136.86
26 Jul 2024,TO TRANSFER-UPI/DR/413628870381/ANITA P/SBIN/spawar3290/UPI--,TRANSFER TO 4897732162091,3375.47,,-18512.33
28 Sep 2024,TO TRANSFER-UPI/DR/418140885923/SAMEER S/KKBK/rahuldixit/UPI--,TRANSFER TO 4897690162095,3543.2,,-22055.53
22 Jul 2024,BY TRANSFER-UPI/CR/477234410634/RAHUL D/HDFC/rahuldixit/Dr Re--,TRANSFER FROM 9137022807,,1894.43,-20161.1
3 Aug 2024,BY TRANSFER-UPI/CR/449718751242/PRIYA K/ICIC/rohit@okhdfc/Dr Re--,TRANSFER FROM 7382910045,,889.09,-19272.01
22 Aug 2024,BY TRANSFER-UPI/CR/473259694080/ANITA P/IDIB/rahuldixit/Dr Re--,TRANSFER FROM 9137022807,,1368.44,-17903.57
4 Sep 2024,TO TRANSFER-UPI/DR/412092439344/SAGAR MO/SBIN/write2same/UPI--,TRANSFER TO 8974521398,2035.71,,-19939.28
22 Jul 2024,BY TRANSFER-UPI/CR/403564621993/PRIYA K/ICIC/spawar3290/Dr Re--,TRANSFER FROM 7382910045,,1459.66,-18479.62
2 Sep 2024,BY TRANSFER-UPI/CR/471408245915/RAHUL D/HDFC/rahuldixit/Dr Re--,TRANSFER FROM 4897732162091,,3762.92,-14716.7
23 Sep 2024,TO TRANSFER-UPI/DR/435086356420/PRIYA K/ICIC/spawar3290/UPI--,TRANSFER TO 7382910045,1614.74,,-16331.44
29 Sep 2024,TO TRANSFER-UPI/DR/466394334362/SAGAR MO/KKBK/rahuldixit/UPI--,TRANSFER TO 4897690162095,1819.7,,-18151.14
30 Jul 2024,TO TRANSFER-UPI/DR/490255030609/ROHIT T/HDFC/rohit@okhdfc/UPI--,TRANSFER TO 9137022807,4995.86,,-23147.0
10 Aug 2024,BY TRANSFER-UPI/CR/482496204498/PRIYA K/SBIN/anitapawar/Dr Re--,TRANSFER FROM 7382910045,,1318.01,-21828.99
15 Aug 2024,TO TRANSFER-UPI/DR/409111543554/ANITA P/ICIC/spawar3290/UPI--,TRANSFER TO 4897690162095,4097.82,,-25926.81
27 Sep 2024,TO TRANSFER-UPI/DR/410143412255/ROHIT T/KKBK/write2same/UPI--,TRANSFER TO 4897732162091,4676.6,,-30603.41
28 Aug 2024,TO TRANSFER-UPI/DR/445592639106/ANITA P/IDIB/write2same/UPI--,TRANSFER TO 4897690162095,4026.55,,-34629.96
24 Jul 2024,BY TRANSFER-UPI/CR/477306951903/ANITA P/SBIN/anitapawar/Dr Re--,TRANSFER FROM 9137022807,,2535.85,-32094.11
26 Aug 2024,BY TRANSFER-UPI/CR/488002598400/SAGAR MO/HDFC/rohit@okhdfc/Dr Re--,TRANSFER FROM 4897732162091,,4805.81,-27288.3
14 Jul 2024,TO TRANSFER-UPI/DR/491335055761/SAMEER S/ICIC/write2same/UPI--,TRANSFER TO 4897732162091,3279.53,,-30567.83
10 Jul 2024,TO TRANSFER-UPI/DR/420069476799/SAMEER S/ICIC/spawar3290/UPI--,TRANSFER TO 4897732162091,1344.13,,-31911.96
4 Sep 2024,BY TRANSFER-UPI/CR/430865688110/SAMEER S/KKBK/anitapawar/Dr Re--,TRANSFER FROM 4897690162095,,3610.25,-28301.71
11 Jul 2024,TO TRANSFER-UPI/DR/493609997697/RAHUL D/HDFC/anitapawar/UPI--,TRANSFER TO 4897732162091,391.91,,-28693.62
3 Jul 2024,TO TRANSFER-UPI/DR/467475746251/SAGAR MO/SBIN/anitapawar/UPI--,TRANSFER TO 9137022807,1299.49,,-29993.11
23 Jul 2024,BY TRANSFER-UPI/CR/445503938111/ANITA P/IDIB/rahuldixit/Dr Re--,TRANSFER FROM 9137022807,,527.25,-29465.86
25 Sep 2024,BY TRANSFER-UPI/CR/473103835226/PRIYA K/SBIN/write2same/Dr Re--,TRANSFER FROM 9137022807,,3565.39,-25900.47
12 Jul 2024,TO TRANSFER-UPI/DR/411007996213/PRIYA K/SBIN/rohit@okhdfc/UPI--,TRANSFER TO 7382910045,4043.81,,-29944.28
17 Sep 2024,TO TRANSFER-UPI/DR/422926148458/MS SANJE/ICIC/rohit@okhdfc/UPI--,TRANSFER TO 4897690162095,2925.32,,-32869.6
12 Sep 2024,TO TRANSFER-UPI/DR/437454079013/ANITA P/SBIN/rahuldixit/UPI--,TRANSFER TO 4897690162095,4426.88,,-37296.48
29 Jul 2024,TO TRANSFER-UPI/DR/493290145493/PRIYA K/KKBK/anitapawar/UPI--,TRANSFER TO 7382910045,4835.5,,-42131.98
20 Sep 2024,BY TRANSFER-UPI/CR/489861294035/ANITA P/SBIN/spawar3290/Dr Re--,TRANSFER FROM 7382910045,,4875.57,-37256.41
30 Jul 2024,BY TRANSFER-UPI/CR/466064632309/ROHIT T/IDIB/rohit@okhdfc/Dr Re--,TRANSFER FROM 8974521398,,2624.42,-34631.99
19 Sep 2024,TO TRANSFER-UPI/DR/414511604948/RAHUL D/HDFC/rohit@okhdfc/UPI--,TRANSFER TO 7382910045,1195.6,,-35827.59
15 Aug 2024,BY TRANSFER-UPI/CR/427288491546/RAHUL D/KKBK/write2same/Dr Re--,TRANSFER FROM 4897690162095,,3863.92,-31963.67
5 Aug 2024,TO TRANSFER-UPI/DR/422693828932/SAGAR MO/SBIN/write2same/UPI--,TRANSFER TO 7382910045,2794.56,,-34758.23
20 Aug 2024,TO TRANSFER-UPI/DR/489377259813/MS SANJE/IDIB/rohit@okhdfc/UPI--,TRANSFER TO 4897732162091,107.61,,-34865.84
10 Jul 2024,BY TRANSFER-UPI/CR/430190395282/RAHUL D/ICIC/write2same/Dr Re--,TRANSFER FROM 4897690162095,,1983.01,-32882.83
28 Sep 2024,TO TRANSFER-UPI/DR/466081905739/MS SANJE/ICIC/anitapawar/UPI--,TRANSFER TO 4897690162095,4783.09,,-37665.92
2 Sep 2024,TO TRANSFER-UPI/DR/435477090746/ANITA P/KKBK/spawar3290/UPI--,TRANSFER TO 8974521398,541.47,,-38207.39
11 Jul 2024,BY TRANSFER-UPI/CR/442083110358/MS SANJE/KKBK/rahuldixit/Dr Re--,TRANSFER FROM 9137022807,,2278.94,-35928.45
26 Sep 2024,TO TRANSFER-UPI/DR/475452462765/SAMEER S/ICIC/spawar3290/UPI--,TRANSFER TO 4897732162091,2077.59,,-38006.04
15 Aug 2024,TO TRANSFER-UPI/DR/412191120963/RAHUL D/HDFC/write2same/UPI--,TRANSFER TO 9137022807,838.44,,-38844.48
13 Jul 2024,BY TRANSFER-UPI/CR/422621113637/ROHIT T/IDIB/spawar3290/Dr Re--,TRANSFER FROM 9137022807,,4472.18,-34372.3
5 Sep 2024,BY TRANSFER-UPI/CR/432891151280/PRIYA K/KKBK/rahuldixit/Dr Re--,TRANSFER FROM 9137022807,,1578.45,-32793.85
31 Aug 2024,BY TRANSFER-UPI/CR/443564192374/ROHIT T/SBIN/spawar3290/Dr Re--,TRANSFER FROM 9137022807,,3445.94,-29347.91
14 Sep 2024,TO TRANSFER-UPI/DR/469693774242/PRIYA K/HDFC/rohit@okhdfc/UPI--,TRANSFER TO 4897732162091,4009.96,,-33357.87
16 Sep 2024,TO TRANSFER-UPI/DR/413846823624/ROHIT T/ICIC/rahuldixit/UPI--,TRANSFER TO 8974521398,3133.57,,-36491.44
15 Aug 2024,TO TRANSFER-UPI/DR/402112095938/MS SANJE/HDFC/write2same/UPI--,TRANSFER TO 4897732162091,1361.58,,-37853.02
3 Aug 2024,TO TRANSFER-UPI/DR/433504812886/SAMEER S/SBIN/rohit@okhdfc/UPI--,TRANSFER TO 4897732162091,4856.3,,-42709.32
29 Sep 2024,TO TRANSFER-UPI/DR/468772384143/SAMEER S/IDIB/write2same/UPI--,TRANSFER TO 7382910045,1455.76,,-44165.08
6 Sep 2024,BY TRANSFER-UPI/CR/442229167723/MS SANJE/HDFC/anitapawar/Dr Re--,TRANSFER FROM 4897732162091,,4188.32,-39976.76
22 Sep 2024,TO TRANSFER-UPI/DR/401772108117/ANITA P/ICIC/rohit@okhdfc/UPI--,TRANSFER TO 8974521398,201.01,,-40177.77
28 Aug 2024,BY TRANSFER-UPI/CR/450702805302/SAGAR MO/ICIC/anitapawar/Dr Re--,TRANSFER FROM 4897690162095,,55.88,-40121.89
20 Sep 2024,BY TRANSFER-UPI/CR/440983877132/ROHIT T/ICIC/write2same/Dr Re--,TRANSFER FROM 7382910045,,2000.07,-38121.82
19 Aug 2024,TO TRANSFER-UPI/DR/464433438569/ROHIT T/ICIC/rahuldixit/UPI--,TRANSFER TO 9137022807,4126.19,,-42248.01
28 Sep 2024,TO TRANSFER-UPI/DR/492397949876/SAGAR MO/ICIC/spawar3290/UPI--,TRANSFER TO 9137022807,3659.12,,-45907.13
21 Aug 2024,TO TRANSFER-UPI/DR/496101560174/SAMEER S/KKBK/spawar3290/UPI--,TRANSFER TO 4897732162091,4595.45,,-50502.58
28 Sep 2024,TO TRANSFER-UPI/DR/406622145742/SAGAR MO/SBIN/write2same/UPI--,TRANSFER TO 4897732162091,2914.1,,-53416.68
19 Aug 2024,TO TRANSFER-UPI/DR/479243680812/SAGAR MO/IDIB/write2same/UPI--,TRANSFER TO 4897732162091,3302.17,,-56718.85
21 Aug 2024,BY TRANSFER-UPI/CR/498454004013/SAGAR MO/SBIN/write2same/Dr Re--,TRANSFER FROM 4897690162095,,974.75,-55744.1
1 Sep 2024,TO TRANSFER-UPI/DR/421385166904/RAHUL D/KKBK/rohit@okhdfc/UPI--,TRANSFER TO 4897732162091,4027.51,,-59771.61
9 Sep 2024,BY TRANSFER-UPI/CR/493481355392/ROHIT T/IDIB/spawar3290/Dr Re--,TRANSFER FROM 8974521398,,256.65,-59514.96
20 Sep 2024,TO TRANSFER-UPI/DR/463703338145/ANITA P/IDIB/rohit@okhdfc/UPI--,TRANSFER TO 4897732162091,1576.8,,-61091.76
8 Sep 2024,TO TRANSFER-UPI/DR/438745020067/SAGAR MO/ICIC/rohit@okhdfc/UPI--,TRANSFER TO 4897732162091,1522.65,,-62614.41
1 Jul 2024,BY TRANSFER-UPI/CR/447353755680/PRIYA K/SBIN/anitapawar/Dr Re--,TRANSFER FROM 9137022807,,3794.35,-58820.06
21 Sep 2024,TO TRANSFER-UPI/DR/453262501408/ROHIT T/SBIN/spawar3290/UPI--,TRANSFER TO 7382910045,1812.2,,-60632.26
12 Jul 2024,TO TRANSFER-UPI/DR/465204023673/ANITA P/SBIN/rohit@okhdfc/UPI--,TRANSFER TO 8974521398,1135.22,,-61767.48
2 Jul 2024,TO TRANSFER-UPI/DR/466631109484/ROHIT T/IDIB/anitapawar/UPI--,TRANSFER TO 7382910045,1600.71,,-63368.19
7 Sep 2024,TO TRANSFER-UPI/DR/406725706259/SAGAR MO/ICIC/rohit@okhdfc/UPI--,TRANSFER TO 4897732162091,276.11,,-63644.3
1 Sep 2024,TO TRANSFER-UPI/DR/446447319686/SAMEER S/HDFC/anitapawar/UPI--,TRANSFER TO 7382910045,422.48,,-64066.78
14 Aug 2024,BY TRANSFER-UPI/CR/418449262992/RAHUL D/KKBK/anitapawar/Dr Re--,TRANSFER FROM 4897690162095,,905.89,-63160.89
19 Aug 2024,TO TRANSFER-UPI/DR/448003891334/ROHIT T/KKBK/rohit@okhdfc/UPI--,TRANSFER TO 4897732162091,4727.68,,-67888.57
26 Jul 2024,BY TRANSFER-UPI/CR/424844490711/RAHUL D/SBIN/anitapawar/Dr Re--,TRANSFER FROM 4897690162095,,2138.78,-65749.79
30 Jul 2024,TO TRANSFER-UPI/DR/472084239845/ROHIT T/SBIN/rahuldixit/UPI--,TRANSFER TO 7382910045,4509.29,,-70259.08
23 Aug 2024,TO TRANSFER-UPI/DR/439170793127/ROHIT T/KKBK/rahuldixit/UPI--,TRANSFER TO 4897690162095,4785.81,,-75044.89
19 Jul 2024,TO TRANSFER-UPI/DR/431721683407/MS SANJE/KKBK/rahuldixit/UPI--,TRANSFER TO 4897690162095,2804.06,,-77848.95
3 Jul 2024,TO TRANSFER-UPI/DR/416830317829/MS SANJE/IDIB/write2same/UPI--,TRANSFER TO 8974521398,545.11,,-78394.06
8 Aug 2024,BY TRANSFER-UPI/CR/415227416344/ANITA P/IDIB/write2same/Dr Re--,TRANSFER FROM 7382910045,,1275.87,-77118.19
21 Aug 2024,BY TRANSFER-UPI/CR/457625946656/MS SANJE/IDIB/rahuldixit/Dr Re--,TRANSFER FROM 4897690162095,,325.35,-76792.84
2 Aug 2024,BY TRANSFER-UPI/CR/434298045078/SAGAR MO/HDFC/spawar3290/Dr Re--,TRANSFER FROM 4897690162095,,996.27,-75796.57
31 Aug 2024,BY TRANSFER-UPI/CR/435766572272/PRIYA K/IDIB/spawar3290/Dr Re--,TRANSFER FROM 9137022807,,3573.44,-72223.13
2 Jul 2024,TO TRANSFER-UPI/DR/498555545710/RAHUL D/ICIC/rahuldixit/UPI--,TRANSFER TO 9137022807,2888.89,,-75112.02
8 Aug 2024,TO TRANSFER-UPI/DR/404586919314/ANITA P/SBIN/rahuldixit/UPI--,TRANSFER TO 9137022807,998.93,,-76110.95
17 Sep 2024,BY TRANSFER-UPI/CR/452018773642/ROHIT T/SBIN/rahuldixit/Dr Re--,TRANSFER FROM 4897690162095,,1732.61,-74378.34
5 Jul 2024,BY TRANSFER-UPI/CR/490689837617/MS SANJE/KKBK/spawar3290/Dr Re--,TRANSFER FROM 7382910045,,2073.57,-72304.77
2 Jul 2024,BY TRANSFER-UPI/CR/420505527582/ANITA P/KKBK/write2same/Dr Re--,TRANSFER FROM 9137022807,,1692.5,-70612.27
28 Jul 2024,TO TRANSFER-UPI/DR/426048538796/SAMEER S/ICIC/anitapawar/UPI--,TRANSFER TO 7382910045,3486.1,,-74098.37
26 Jul 2024,TO TRANSFER-UPI/DR/416019984769/PRIYA K/KKBK/rohit@okhdfc/UPI--,TRANSFER TO 4897732162091,3074.28,,-77172.65
24 Sep 2024,BY TRANSFER-UPI/CR/400208122087/RAHUL D/IDIB/rohit@okhdfc/Dr Re--,TRANSFER FROM 4897732162091,,2926.52,-74246.13
18 Aug 2024,TO TRANSFER-UPI/DR/474487219758/ROHIT T/KKBK/anitapawar/UPI--,TRANSFER TO 8974521398,3953.43,,-78199.56
16 Jul 2024,TO TRANSFER-UPI/DR/408816924270/ANITA P/KKBK/spawar3290/UPI--,TRANSFER TO 7382910045,3501.36,,-81700.92
1 Jul 2024,TO TRANSFER-UPI/DR/446665734929/SAMEER S/SBIN/rahuldixit/UPI--,TRANSFER TO 9137022807,847.69,,-82548.61
11 Jul 2024,TO TRANSFER-UPI/DR/425587750619/ROHIT T/ICIC/spawar3290/UPI--,TRANSFER TO 7382910045,4440.31,,-86988.92
20 Sep 2024,TO TRANSFER-UPI/DR/440862932623/ROHIT T/IDIB/rohit@okhdfc/UPI--,TRANSFER TO 4897732162091,1271.35,,-88260.27
15 Jul 2024,TO TRANSFER-UPI/DR/484125980140/ANITA P/HDFC/anitapawar/UPI--,TRANSFER TO 8974521398,2066.51,,-90326.78
12 Aug 2024,BY TRANSFER-UPI/CR/430275495880/PRIYA K/KKBK/anitapawar/Dr Re--,TRANSFER FROM 4897732162091,,1762.13,-88564.65
26 Aug 2024,BY TRANSFER-UPI/CR/475004710050/ROHIT T/ICIC/rahuldixit/Dr Re--,TRANSFER FROM 9137022807,,1166.58,-87398.07
14 Sep 2024,BY TRANSFER-UPI/CR/427492386242/SAGAR MO/IDIB/anitapawar/Dr Re--,TRANSFER FROM 7382910045,,2934.64,-84463.43
10 Aug 2024,TO TRANSFER-UPI/DR/462120983751/ANITA P/HDFC/rohit@okhdfc/UPI--,TRANSFER TO 4897732162091,3321.47,,-87784.9
31 Jul 2024,TO TRANSFER-UPI/DR/445985271395/SAGAR MO/KKBK/rohit@okhdfc/UPI--,TRANSFER TO 7382910045,2662.84,,-90447.74
19 Aug 2024,TO TRANSFER-UPI/DR/409222227088/ROHIT T/KKBK/spawar3290/UPI--,TRANSFER TO 8974521398,743.1,,-91190.84
16 Jul 2024,TO TRANSFER-UPI/DR/418284759828/PRIYA K/ICIC/write2same/UPI--,TRANSFER TO 4897690162095,3195.98,,-94386.82
10 Aug 2024,BY TRANSFER-UPI/CR/460540899232/SAMEER S/IDIB/rahuldixit/Dr Re--,TRANSFER FROM 8974521398,,3581.8,-90805.02
30 Jul 2024,BY TRANSFER-UPI/CR/419110625486/ROHIT T/ICIC/rohit@okhdfc/Dr Re--,TRANSFER FROM 7382910045,,3615.66,-87189.36
12 Jul 2024,BY TRANSFER-UPI/CR/457848144374/ANITA P/ICIC/write2same/Dr Re--,TRANSFER FROM 8974521398,,4026.3,-83163.06
16 Jul 2024,TO TRANSFER-UPI/DR/414799075250/SAGAR MO/HDFC/rahuldixit/UPI--,TRANSFER TO 7382910045,164.25,,-83327.31
31 Jul 2024,BY TRANSFER-UPI/CR/434616808540/ROHIT T/SBIN/spawar3290/Dr Re--,TRANSFER FROM 4897690162095,,4954.88,-78372.43
29 Sep 2024,BY TRANSFER-UPI/CR/465955227784/RAHUL D/KKBK/spawar3290/Dr Re--,TRANSFER FROM 7382910045,,1337.32,-77035.11
19 Aug 2024,BY TRANSFER-UPI/CR/442634555501/PRIYA K/KKBK/write2same/Dr Re--,TRANSFER FROM 9137022807,,2315.88,-74719.23
20 Jul 2024,TO TRANSFER-UPI/DR/499404514294/PRIYA K/SBIN/rahuldixit/UPI--,TRANSFER TO 7382910045,3142.19,,-77861.42
5 Jul 2024,TO TRANSFER-UPI/DR/494480688769/SAMEER S/IDIB/spawar3290/UPI--,TRANSFER TO 9137022807,1334.78,,-79196.2
7 Sep 2024,BY TRANSFER-UPI/CR/415647405618/ROHIT T/IDIB/anitapawar/Dr Re--,TRANSFER FROM 9137022807,,1059.44,-78136.76
13 Sep 2024,TO TRANSFER-UPI/DR/457594166124/ANITA P/KKBK/write2same/UPI--,TRANSFER TO 4897732162091,1015.2,,-79151.96
3 Aug 2024,TO TRANSFER-UPI/DR/434786847062/MS SANJE/SBIN/rahuldixit/UPI--,TRANSFER TO 4897732162091,2504.55,,-81656.51
4 Sep 2024,BY TRANSFER-UPI/CR/428116448957/RAHUL D/IDIB/rohit@okhdfc/Dr Re--,TRANSFER FROM 8974521398,,2351.14,-79305.37
25 Sep 2024,BY TRANSFER-UPI/CR/422912314979/PRIYA K/IDIB/anitapawar/Dr Re--,TRANSFER FROM 9137022807,,1418.39,-77886.98
19 Jul 2024,BY TRANSFER-UPI/CR/438007321638/SAGAR MO/HDFC/rohit@okhdfc/Dr Re--,TRANSFER FROM 8974521398,,2655.07,-75231.91
12 Jul 2024,BY TRANSFER-UPI/CR/465139468663/RAHUL D/ICIC/rahuldixit/Dr Re--,TRANSFER FROM 8974521398,,51.0,-75180.91
20 Aug 2024,TO TRANSFER-UPI/DR/411095982425/PRIYA K/HDFC/rahuldixit/UPI--,TRANSFER TO 7382910045,3953.03,,-79133.94
1 Jul 2024,TO TRANSFER-UPI/DR/459044063440/ROHIT T/IDIB/anitapawar/UPI--,TRANSFER TO 8974521398,2835.18,,-81969.12
10 Jul 2024,BY TRANSFER-UPI/CR/456195083681/PRIYA K/IDIB/anitapawar/Dr Re--,TRANSFER FROM 4897690162095,,2602.21,-79366.91
19 Sep 2024,BY TRANSFER-UPI/CR/470806374295/MS SANJE/HDFC/spawar3290/Dr Re--,TRANSFER FROM 8974521398,,4750.99,-74615.92
18 Aug 2024,TO TRANSFER-UPI/DR/408480033192/RAHUL D/IDIB/spawar3290/UPI--,TRANSFER TO 9137022807,1093.73,,-75709.65
1 Jul 2024,TO TRANSFER-UPI/DR/496767788416/RAHUL D/IDIB/anitapawar/UPI--,TRANSFER TO 4897690162095,680.07,,-76389.72
19 Aug 2024,BY TRANSFER-UPI/CR/414992255296/RAHUL D/HDFC/rahuldixit/Dr Re--,TRANSFER FROM 9137022807,,1268.37,-75121.35
18 Sep 2024,TO TRANSFER-UPI/DR/492976461716/SAGAR MO/ICIC/write2same/UPI--,TRANSFER TO 4897690162095,3363.46,,-78484.81
30 Jul 2024,TO TRANSFER-UPI/DR/450445860339/PRIYA K/KKBK/rohit@okhdfc/UPI--,TRANSFER TO 9137022807,750.52,,-79235.33
7 Jul 2024,TO TRANSFER-UPI/DR/419752938854/PRIYA K/KKBK/rahuldixit/UPI--,TRANSFER TO 7382910045,1216.43,,-80451.76
23 Jul 2024,TO TRANSFER-UPI/DR/472885940975/ROHIT T/SBIN/anitapawar/UPI--,TRANSFER TO 9137022807,380.39,,-80832.15
5 Jul 2024,BY TRANSFER-UPI/CR/434242338393/MS SANJE/ICIC/rohit@okhdfc/Dr Re--,TRANSFER FROM 8974521398,,1906.37,-78925.78
20 Jul 2024,TO TRANSFER-UPI/DR/440456658163/PRIYA K/KKBK/write2same/UPI--,TRANSFER TO 7382910045,1918.05,,-80843.83
3 Jul 2024,TO TRANSFER-UPI/DR/416398966730/SAGAR MO/IDIB/anitapawar/UPI--,TRANSFER TO 4897690162095,1262.41,,-82106.24
1 Aug 2024,BY TRANSFER-UPI/CR/400594476903/RAHUL D/IDIB/rahuldixit/Dr Re--,TRANSFER FROM 8974521398,,1729.99,-80376.25
10 Jul 2024,BY TRANSFER-UPI/CR/406006136775/ROHIT T/ICIC/rahuldixit/Dr Re--,TRANSFER FROM 8974521398,,920.37,-79455.88
14 Sep 2024,TO TRANSFER-UPI/DR/425763300185/ROHIT T/IDIB/anitapawar/UPI--,TRANSFER TO 4897690162095,2879.77,,-82335.65
5 Sep 2024,BY TRANSFER-UPI/CR/440015362804/SAMEER S/KKBK/spawar3290/Dr Re--,TRANSFER FROM 4897690162095,,2939.07,-79396.58
27 Jul 2024,BY TRANSFER-UPI/CR/456476348184/MS SANJE/SBIN/rohit@okhdfc/Dr Re--,TRANSFER FROM 7382910045,,2281.26,-77115.32
7 Aug 2024,TO TRANSFER-UPI/DR/429140253913/SAGAR MO/KKBK/rahuldixit/UPI--,TRANSFER TO 4897732162091,460.21,,-77575.53
5 Sep 2024,TO TRANSFER-UPI/DR/434030225188/SAGAR MO/SBIN/spawar3290/UPI--,TRANSFER TO 9137022807,1834.09,,-79409.62
3 Aug 2024,BY TRANSFER-UPI/CR/468620880597/PRIYA K/KKBK/write2same/Dr Re--,TRANSFER FROM 4897732162091,,2562.08,-76847.54
15 Sep 2024,BY TRANSFER-UPI/CR/449142145470/SAMEER S/ICIC/write2same/Dr Re--,TRANSFER FROM 9137022807,,614.85,-76232.69
3 Aug 2024,BY TRANSFER-UPI/CR/421992076334/MS SANJE/IDIB/rohit@okhdfc/Dr Re--,TRANSFER FROM 8974521398,,425.99,-75806.7
5 Aug 2024,TO TRANSFER-UPI/DR/467022329489/SAGAR MO/IDIB/anitapawar/UPI--,TRANSFER TO 7382910045,1897.57,,-77704.27
31 Aug 2024,BY TRANSFER-UPI/CR/433272371248/SAGAR MO/HDFC/spawar3290/Dr Re--,TRANSFER FROM 9137022807,,512.41,-77191.86
11 Jul 2024,TO TRANSFER-UPI/DR/442448630083/ROHIT T/HDFC/anitapawar/UPI--,TRANSFER TO 9137022807,1487.05,,-78678.91
29 Jul 2024,TO TRANSFER-UPI/DR/426067545216/RAHUL D/HDFC/write2same/UPI--,TRANSFER TO 4897732162091,2727.56,,-81406.47
15 Sep 2024,TO TRANSFER-UPI/DR/452819991705/ROHIT T/SBIN/anitapawar/UPI--,TRANSFER TO 4897690162095,2386.94,,-83793.41
19 Jul 2024,TO TRANSFER-UPI/DR/407618493158/RAHUL D/SBIN/rohit@okhdfc/UPI--,TRANSFER TO 7382910045,3215.25,,-87008.66
20 Jul 2024,TO TRANSFER-UPI/DR/418000411658/PRIYA K/ICIC/rohit@okhdfc/UPI--,TRANSFER TO 4897690162095,3771.19,,-90779.85
19 Sep 2024,TO TRANSFER-UPI/DR/447555254837/RAHUL D/KKBK/spawar3290/UPI--,TRANSFER TO 4897690162095,1625.4,,-92405.25
24 Sep 2024,TO TRANSFER-UPI/DR/416911815576/RAHUL D/HDFC/write2same/UPI--,TRANSFER TO 8974521398,1376.27,,-93781.52
16 Aug 2024,BY TRANSFER-UPI/CR/405294455405/MS SANJE/IDIB/rohit@okhdfc/Dr Re--,TRANSFER FROM 4897732162091,,4787.94,-88993.58
29 Aug 2024,TO TRANSFER-UPI/DR/403772004130/MS SANJE/HDFC/rohit@okhdfc/UPI--,TRANSFER TO 4897732162091,1347.42,,-90341.0
27 Aug 2024,BY TRANSFER-UPI/CR/492382259874/ROHIT T/IDIB/spawar3290/Dr Re--,TRANSFER FROM 7382910045,,1870.85,-88470.15
28 Sep 2024,BY TRANSFER-UPI/CR/479745914994/PRIYA K/KKBK/rohit@okhdfc/Dr Re--,TRANSFER FROM 7382910045,,921.64,-87548.51
28 Sep 2024,BY TRANSFER-UPI/CR/432821216404/MS SANJE/KKBK/spawar3290/Dr Re--,TRANSFER FROM 7382910045,,2285.13,-85263.38
26 Jul 2024,TO TRANSFER-UPI/DR/491632545457/MS SANJE/ICIC/anitapawar/UPI--,TRANSFER TO 4897732162091,4159.4,,-89422.78
24 Sep 2024,BY TRANSFER-UPI/CR/429005833517/SAMEER S/ICIC/write2same/Dr Re--,TRANSFER FROM 4897690162095,,2991.61,-86431.17
29 Aug 2024,TO TRANSFER-UPI/DR/466164353118/MS SANJE/HDFC/anitapawar/UPI--,TRANSFER TO 4897690162095,1812.68,,-88243.85
4 Jul 2024,TO TRANSFER-UPI/DR/443697147831/PRIYA K/SBIN/rohit@okhdfc/UPI--,TRANSFER TO 8974521398,4915.45,,-93159.3
18 Sep 2024,TO TRANSFER-UPI/DR/453330262704/SAMEER S/ICIC/anitapawar/UPI--,TRANSFER TO 9137022807,217.2,,-93376.5
29 Sep 2024,TO TRANSFER-UPI/DR/452211340106/MS SANJE/SBIN/anitapawar/UPI--,TRANSFER TO 4897690162095,1437.73,,-94814.23
16 Aug 2024,BY TRANSFER-UPI/CR/423852082006/SAGAR MO/ICIC/spawar3290/Dr Re--,TRANSFER FROM 8974521398,,2026.59,-92787.64
2 Jul 2024,TO TRANSFER-UPI/DR/465225310931/PRIYA K/ICIC/rahuldixit/UPI--,TRANSFER TO 7382910045,2310.23,,-95097.87
13 Sep 2024,TO TRANSFER-UPI/DR/491086453151/RAHUL D/ICIC/spawar3290/UPI--,TRANSFER TO 4897690162095,4305.68,,-99403.55
2 Jul 2024,TO TRANSFER-UPI/DR/414092881382/ANITA P/IDIB/write2same/UPI--,TRANSFER TO 4897690162095,4818.59,,-104222.14
16 Aug 2024,TO TRANSFER-UPI/DR/401115050350/SAGAR MO/HDFC/spawar3290/UPI--,TRANSFER TO 8974521398,3136.8,,-107358.94
3 Aug 2024,BY TRANSFER-UPI/CR/448546142028/ANITA P/SBIN/rohit@okhdfc/Dr Re--,TRANSFER FROM 9137022807,,1508.92,-105850.02
24 Sep 2024,BY TRANSFER-UPI/CR/426254024955/PRIYA K/HDFC/anitapawar/Dr Re--,TRANSFER FROM 9137022807,,3948.57,-101901.45
19 Aug 2024,TO TRANSFER-UPI/DR/455965470378/ANITA P/SBIN/rohit@okhdfc/UPI--,TRANSFER TO 7382910045,3476.24,,-105377.69
5 Jul 2024,BY TRANSFER-UPI/CR/488892855058/SAGAR MO/ICIC/write2same/Dr Re--,TRANSFER FROM 7382910045,,3917.45,-101460.24
22 Aug 2024,BY TRANSFER-UPI/CR/470836672989/PRIYA K/SBIN/rahuldixit/Dr Re--,TRANSFER FROM 9137022807,,4862.88,-96597.36
23 Sep 2024,BY TRANSFER-UPI/CR/468805812708/MS SANJE/IDIB/rohit@okhdfc/Dr Re--,TRANSFER FROM 4897732162091,,231.94,-96365.42
23 Aug 2024,BY TRANSFER-UPI/CR/460643148820/MS SANJE/IDIB/rahuldixit/Dr Re--,TRANSFER FROM 4897732162091,,1186.62,-95178.8
10 Jul 2024,BY TRANSFER-UPI/CR/463376688207/SAGAR MO/HDFC/write2same/Dr Re--,TRANSFER FROM 7382910045,,1964.67,-93214.13
23 Jul 2024,BY TRANSFER-UPI/CR/484609364378/SAMEER S/IDIB/write2same/Dr Re--,TRANSFER FROM 8974521398,,598.42,-92615.71
5 Sep 2024,BY TRANSFER-UPI/CR/432645098109/ROHIT T/KKBK/write2same/Dr Re--,TRANSFER FROM 4897690162095,,91.36,-92524.35
15 Aug 2024,TO TRANSFER-UPI/DR/414365103802/ANITA P/KKBK/rahuldixit/UPI--,TRANSFER TO 4897690162095,1672.69,,-94197.04
4 Jul 2024,BY TRANSFER-UPI/CR/484094431460/SAGAR MO/IDIB/anitapawar/Dr Re--,TRANSFER FROM 9137022807,,3404.47,-90792.57
7 Jul 2024,BY TRANSFER-UPI/CR/492242053698/PRIYA K/HDFC/spawar3290/Dr Re--,TRANSFER FROM 9137022807,,1517.6,-89274.97
8 Sep 2024,BY TRANSFER-UPI/CR/465826539510/RAHUL D/SBIN/spawar3290/Dr Re--,TRANSFER FROM 7382910045,,2278.31,-86996.66
14 Aug 2024,BY TRANSFER-UPI/CR/469299926694/PRIYA K/ICIC/rahuldixit/Dr Re--,TRANSFER FROM 8974521398,,62.13,-86934.53
24 Aug 2024,BY TRANSFER-UPI/CR/454880570429/ROHIT T/ICIC/write2same/Dr Re--,TRANSFER FROM 9137022807,,3683.64,-83250.89
30 Sep 2024,TO TRANSFER-UPI/DR/401029186777/ROHIT T/HDFC/write2same/UPI--,TRANSFER TO 4897732162091,4562.35,,-87813.24
7 Sep 2024,BY TRANSFER-UPI/CR/491232689536/RAHUL D/IDIB/rahuldixit/Dr Re--,TRANSFER FROM 8974521398,,2012.39,-85800.85
10 Aug 2024,TO TRANSFER-UPI/DR/496623980459/MS SANJE/HDFC/rahuldixit/UPI--,TRANSFER TO 4897690162095,4242.38,,-90043.23
11 Aug 2024,TO TRANSFER-UPI/DR/442376625283/ROHIT T/IDIB/write2same/UPI--,TRANSFER TO 4897690162095,3454.72,,-93497.95
10 Aug 2024,TO TRANSFER-UPI/DR/437473740571/SAGAR MO/ICIC/rohit@okhdfc/UPI--,TRANSFER TO 4897732162091,1685.89,,-95183.84
19 Jul 2024,TO TRANSFER-UPI/DR/487836061011/PRIYA K/ICIC/rahuldixit/UPI--,TRANSFER TO 8974521398,4726.76,,-99910.6
19 Aug 2024,TO TRANSFER-UPI/DR/466271434633/SAMEER S/KKBK/rahuldixit/UPI--,TRANSFER TO 4897732162091,3941.71,,-103852.31
13 Jul 2024,TO TRANSFER-UPI/DR/471072321049/ROHIT T/HDFC/write2same/UPI--,TRANSFER TO 8974521398,1357.79,,-105210.1
4 Sep 2024,TO TRANSFER-UPI/DR/401739537590/SAGAR MO/KKBK/write2same/UPI--,TRANSFER TO 8974521398,749.8,,-105959.9
24 Aug 2024,TO TRANSFER-UPI/DR/474032709344/ANITA P/KKBK/rohit@okhdfc/UPI--,TRANSFER TO 9137022807,1203.0,,-107162.9
21 Aug 2024,TO TRANSFER-UPI/DR/449375419490/MS SANJE/SBIN/rohit@okhdfc/UPI--,TRANSFER TO 4897690162095,1428.14,,-108591.04
15 Aug 2024,TO TRANSFER-UPI/DR/442561260710/MS SANJE/KKBK/spawar3290/UPI--,TRANSFER TO 9137022807,3311.06,,-111902.1
12 Jul 2024,BY TRANSFER-UPI/CR/414876759232/RAHUL D/HDFC/rohit@okhdfc/Dr Re--,TRANSFER FROM 9137022807,,134.36,-111767.74
12 Jul 2024,TO TRANSFER-UPI/DR/474087719784/SAGAR MO/SBIN/rahuldixit/UPI--,TRANSFER TO 8974521398,2516.81,,-114284.55
4 Jul 2024,TO TRANSFER-UPI/DR/482331432294/RAHUL D/SBIN/write2same/UPI--,TRANSFER TO 4897690162095,3187.64,,-117472.19
13 Sep 2024,BY TRANSFER-UPI/CR/428696229810/RAHUL D/KKBK/spawar3290/Dr Re--,TRANSFER FROM 7382910045,,4766.41,-112705.78
15 Sep 2024,BY TRANSFER-UPI/CR/435120219901/SAGAR MO/KKBK/spawar3290/Dr Re--,TRANSFER FROM 4897732162091,,1083.0,-111622.78
25 Aug 2024,BY TRANSFER-UPI/CR/437354120629/SAGAR MO/SBIN/anitapawar/Dr Re--,TRANSFER FROM 8974521398,,2846.72,-108776.06
6 Sep 2024,BY TRANSFER-UPI/CR/430063041668/PRIYA K/ICIC/spawar3290/Dr Re--,TRANSFER FROM 8974521398,,1566.39,-107209.67
30 Jul 2024,TO TRANSFER-UPI/DR/443666083508/MS SANJE/HDFC/rohit@okhdfc/UPI--,TRANSFER TO 8974521398,3526.14,,-110735.81
11 Jul 2024,TO TRANSFER-UPI/DR/453748777019/PRIYA K/KKBK/spawar3290/UPI--,TRANSFER TO 4897690162095,542.8,,-111278.61
12 Jul 2024,TO TRANSFER-UPI/DR/415301543294/ANITA P/IDIB/anitapawar/UPI--,TRANSFER TO 8974521398,1935.06,,-113213.67
1 Jul 2024,TO TRANSFER-UPI/DR/442532707218/SAGAR MO/ICIC/rahuldixit/UPI--,TRANSFER TO 9137022807,3695.94,,-116909.61
9 Jul 2024,TO TRANSFER-UPI/DR/431127294953/RAHUL D/ICIC/rahuldixit/UPI--,TRANSFER TO 9137022807,2519.2,,-119428.81
14 Aug 2024,TO TRANSFER-UPI/DR/493651866290/SAGAR MO/SBIN/rahuldixit/UPI--,TRANSFER TO 7382910045,832.5,,-120261.31
14 Sep 2024,TO TRANSFER-UPI/DR/424921400317/RAHUL D/IDIB/rahuldixit/UPI--,TRANSFER TO 4897690162095,2920.01,,-123181.32
23 Sep 2024,TO TRANSFER-UPI/DR/406535290692/MS SANJE/IDIB/rahuldixit/UPI--,TRANSFER TO 9137022807,1623.99,,-124805.31
24 Sep 2024,BY TRANSFER-UPI/CR/481834060595/PRIYA K/ICIC/rohit@okhdfc/Dr Re--,TRANSFER FROM 4897690162095,,2523.75,-122281.56
21 Sep 2024,TO TRANSFER-UPI/DR/435221264358/ROHIT T/HDFC/anitapawar/UPI--,TRANSFER TO 4897690162095,2107.22,,-124388.78
13 Sep 2024,BY TRANSFER-UPI/CR/402867173782/PRIYA K/HDFC/write2same/Dr Re--,TRANSFER FROM 8974521398,,3885.68,-120503.1
28 Sep 2024,BY TRANSFER-UPI/CR/406029077270/PRIYA K/SBIN/spawar3290/Dr Re--,TRANSFER FROM 7382910045,,1972.9,-118530.2
20 Jul 2024,TO TRANSFER-UPI/DR/469847956276/ROHIT T/HDFC/spawar3290/UPI--,TRANSFER TO 4897690162095,2562.41,,-121092.61
5 Aug 2024,TO TRANSFER-UPI/DR/410889507461/ROHIT T/KKBK/rahuldixit/UPI--,TRANSFER TO 8974521398,2736.79,,-123829.4
5 Jul 2024,TO TRANSFER-UPI/DR/463114647903/ROHIT T/HDFC/rahuldixit/UPI--,TRANSFER TO 8974521398,4211.35,,-128040.75
12 Sep 2024,TO TRANSFER-UPI/DR/446954320768/ROHIT T/ICIC/spawar3290/UPI--,TRANSFER TO 7382910045,3113.33,,-131154.08
30 Aug 2024,TO TRANSFER-UPI/DR/487010745205/RAHUL D/KKBK/spawar3290/UPI--,TRANSFER TO 9137022807,1434.83,,-132588.91
7 Aug 2024,BY TRANSFER-UPI/CR/495629151517/SAMEER S/IDIB/rohit@okhdfc/Dr Re--,TRANSFER FROM 4897690162095,,95.57,-132493.34
13 Aug 2024,BY TRANSFER-UPI/CR/449410732926/ROHIT T/SBIN/rahuldixit/Dr Re--,TRANSFER FROM 4897690162095,,117.3,-132376.04
26 Sep 2024,BY TRANSFER-UPI/CR/466046953288/SAMEER S/ICIC/rahuldixit/Dr Re--,TRANSFER FROM 8974521398,,4164.03,-128212.01
20 Aug 2024,BY TRANSFER-UPI/CR/487800946510/SAMEER S/KKBK/rahuldixit/Dr Re--,TRANSFER FROM 4897732162091,,3218.89,-124993.12
9 Sep 2024,TO TRANSFER-UPI/DR/476739063749/RAHUL D/KKBK/rohit@okhdfc/UPI--,TRANSFER TO 4897732162091,556.36,,-125549.48
29 Jul 2024,BY TRANSFER-UPI/CR/411691806705/SAMEER S/IDIB/write2same/Dr Re--,TRANSFER FROM 8974521398,,3465.63,-122083.85
11 Aug 2024,TO TRANSFER-UPI/DR/470524445861/RAHUL D/SBIN/spawar3290/UPI--,TRANSFER TO 4897732162091,312.52,,-122396.37
21 Sep 2024,TO TRANSFER-UPI/DR/440989907774/SAGAR MO/SBIN/rohit@okhdfc/UPI--,TRANSFER TO 4897732162091,4451.12,,-126847.49
28 Aug 2024,BY TRANSFER-UPI/CR/479549090143/ANITA P/IDIB/spawar3290/Dr Re--,TRANSFER FROM 9137022807,,4182.0,-122665.49
11 Sep 2024,TO TRANSFER-UPI/DR/443606979097/ROHIT T/SBIN/spawar3290/UPI--,TRANSFER TO 7382910045,2403.42,,-125068.91
26 Sep 2024,TO TRANSFER-UPI/DR/467874464443/SAGAR MO/HDFC/rahuldixit/UPI--,TRANSFER TO 4897690162095,1155.18,,-126224.09
4 Jul 2024,BY TRANSFER-UPI/CR/482243401392/ROHIT T/IDIB/rohit@okhdfc/Dr Re--,TRANSFER FROM 8974521398,,4395.24,-121828.85
9 Sep 2024,TO TRANSFER-UPI/DR/477387944599/MS SANJE/HDFC/write2same/UPI--,TRANSFER TO 7382910045,4818.72,,-126647.57
16 Sep 2024,BY TRANSFER-UPI/CR/487489220931/SAMEER S/SBIN/write2same/Dr Re--,TRANSFER FROM 8974521398,,2946.89,-123700.68
25 Aug 2024,TO TRANSFER-UPI/DR/415008659401/MS SANJE/HDFC/write2same/UPI--,TRANSFER TO 8974521398,1241.27,,-124941.95
6 Jul 2024,TO TRANSFER-UPI/DR/450911593710/RAHUL D/IDIB/anitapawar/UPI--,TRANSFER TO 9137022807,376.94,,-125318.89
29 Jul 2024,BY TRANSFER-UPI/CR/441851645178/MS SANJE/HDFC/anitapawar/Dr Re--,TRANSFER FROM 9137022807,,810.85,-124508.04
6 Jul 2024,TO TRANSFER-UPI/DR/403603136911/PRIYA K/KKBK/write2same/UPI--,TRANSFER TO 9137022807,381.81,,-124889.85
4 Jul 2024,TO TRANSFER-UPI/DR/425153913960/RAHUL D/KKBK/rohit@okhdfc/UPI--,TRANSFER TO 8974521398,3120.19,,-128010.04
5 Sep 2024,TO TRANSFER-UPI/DR/478594294640/ANITA P/ICIC/rahuldixit/UPI--,TRANSFER TO 4897732162091,2693.06,,-130703.1
20 Jul 2024,BY TRANSFER-UPI/CR/445803574246/SAMEER S/KKBK/rahuldixit/Dr Re--,TRANSFER FROM 7382910045,,1587.53,-129115.57
7 Aug 2024,BY TRANSFER-UPI/CR/458444337302/ROHIT T/ICIC/spawar3290/Dr Re--,TRANSFER FROM 4897732162091,,4098.79,-125016.78
29 Aug 2024,BY TRANSFER-UPI/CR/413796751198/ANITA P/HDFC/write2same/Dr Re--,TRANSFER FROM 7382910045,,1349.42,-123667.36
22 Sep 2024,TO TRANSFER-UPI/DR/461595685255/ROHIT T/ICIC/anitapawar/UPI--,TRANSFER TO 4897732162091,1782.44,,-125449.8
5 Aug 2024,BY TRANSFER-UPI/CR/458161418311/MS SANJE/KKBK/write2same/Dr Re--,TRANSFER FROM 9137022807,,4514.03,-120935.77
20 Sep 2024,BY TRANSFER-UPI/CR/415192017895/ANITA P/HDFC/spawar3290/Dr Re--,TRANSFER FROM 4897732162091,,1928.46,-119007.31
11 Sep 2024,TO TRANSFER-UPI/DR/409498501941/ROHIT T/IDIB/rohit@okhdfc/UPI--,TRANSFER TO 8974521398,1897.51,,-120904.82
17 Jul 2024,TO TRANSFER-UPI/DR/413427144453/MS SANJE/IDIB/spawar3290/UPI--,TRANSFER TO 4897732162091,461.92,,-121366.74
2 Jul 2024,TO TRANSFER-UPI/DR/478925443627/SAMEER S/SBIN/rohit@okhdfc/UPI--,TRANSFER TO 4897732162091,4143.08,,-125509.82
2 Aug 2024,TO TRANSFER-UPI/DR/496001230817/ROHIT T/KKBK/anitapawar/UPI--,TRANSFER TO 9137022807,2220.31,,-127730.13
3 Sep 2024,TO TRANSFER-UPI/DR/434332596651/ROHIT T/KKBK/rahuldixit/UPI--,TRANSFER TO 9137022807,361.15,,-128091.28
31 Aug 2024,BY TRANSFER-UPI/CR/412910788373/ANITA P/ICIC/rohit@okhdfc/Dr Re--,TRANSFER FROM 4897690162095,,3766.59,-124324.69
17 Sep 2024,BY TRANSFER-UPI/CR/459266944635/MS SANJE/SBIN/anitapawar/Dr Re--,TRANSFER FROM 8974521398,,4761.27,-119563.42
13 Sep 2024,TO TRANSFER-UPI/DR/498298422450/PRIYA K/ICIC/anitapawar/UPI--,TRANSFER TO 8974521398,202.86,,-119766.28
4 Sep 2024,TO TRANSFER-UPI/DR/455590385407/PRIYA K/HDFC/rohit@okhdfc/UPI--,TRANSFER TO 7382910045,2848.07,,-122614.35
12 Aug 2024,BY TRANSFER-UPI/CR/498014485144/RAHUL D/IDIB/write2same/Dr Re--,TRANSFER FROM 7382910045,,4947.04,-117667.31
16 Jul 2024,TO TRANSFER-UPI/DR/462509728890/ANITA P/ICIC/rahuldixit/UPI--,TRANSFER TO 4897732162091,2122.93,,-119790.24
10 Aug 2024,BY TRANSFER-UPI/CR/497811775950/ANITA P/HDFC/rohit@okhdfc/Dr Re--,TRANSFER FROM 4897690162095,,1254.73,-118535.51
3 Sep 2024,TO TRANSFER-UPI/DR/449446381633/SAMEER S/KKBK/anitapawar/UPI--,TRANSFER TO 4897732162091,1585.58,,-120121.09
4 Jul 2024,BY TRANSFER-UPI/CR/422139540604/SAMEER S/SBIN/anitapawar/Dr Re--,TRANSFER FROM 4897732162091,,4163.9,-115957.19
9 Sep 2024,TO TRANSFER-UPI/DR/425422435910/ANITA P/ICIC/write2same/UPI--,TRANSFER TO 8974521398,1918.39,,-117875.58
7 Jul 2024,TO TRANSFER-UPI/DR/415988911102/MS SANJE/KKBK/write2same/UPI--,TRANSFER TO 9137022807,4085.74,,-121961.32
15 Sep 2024,BY TRANSFER-UPI/CR/492017669306/RAHUL D/HDFC/rohit@okhdfc/Dr Re--,TRANSFER FROM 4897690162095,,3510.41,-118450.91
20 Aug 2024,TO TRANSFER-UPI/DR/436436828571/PRIYA K/IDIB/spawar3290/UPI--,TRANSFER TO 4897690162095,3665.47,,-122116.38
11 Sep 2024,BY TRANSFER-UPI/CR/410933747552/RAHUL D/IDIB/spawar3290/Dr Re--,TRANSFER FROM 4897690162095,,618.81,-121497.57
25 Jul 2024,TO TRANSFER-UPI/DR/468097574656/ANITA P/KKBK/rahuldixit/UPI--,TRANSFER TO 8974521398,68.97,,-121566.54
30 Aug 2024,TO TRANSFER-UPI/DR/440745135814/ROHIT T/ICIC/spawar3290/UPI--,TRANSFER TO 4897690162095,3657.2,,-125223.74
28 Sep 2024,BY TRANSFER-UPI/CR/482184502460/RAHUL D/HDFC/anitapawar/Dr Re--,TRANSFER FROM 4897732162091,,4419.52,-120804.22
2 Sep 2024,TO TRANSFER-UPI/DR/440286758439/PRIYA K/KKBK/anitapawar/UPI--,TRANSFER TO 9137022807,3228.39,,-124032.61
7 Sep 2024,BY TRANSFER-UPI/CR/497983151487/PRIYA K/HDFC/anitapawar/Dr Re--,TRANSFER FROM 4897690162095,,2595.12,-121437.49
16 Sep 2024,TO TRANSFER-UPI/DR/414343665282/ANITA P/SBIN/anitapawar/UPI--,TRANSFER TO 7382910045,2753.32,,-124190.81
12 Sep 2024,TO TRANSFER-UPI/DR/431574071495/MS SANJE/SBIN/rahuldixit/UPI--,TRANSFER TO 9137022807,179.22,,-124370.03
26 Sep 2024,BY TRANSFER-UPI/CR/487091320968/MS SANJE/ICIC/write2same/Dr Re--,TRANSFER FROM 9137022807,,700.79,-123669.24
26 Jul 2024,BY TRANSFER-UPI/CR/442903672278/PRIYA K/ICIC/write2same/Dr Re--,TRANSFER FROM 4897690162095,,1593.4,-122075.84
14 Aug 2024,TO TRANSFER-UPI/DR/411605653334/SAGAR MO/KKBK/spawar3290/UPI--,TRANSFER TO 4897690162095,4088.34,,-126164.18
18 Sep 2024,BY TRANSFER-UPI/CR/413627922468/SAGAR MO/KKBK/anitapawar/Dr Re--,TRANSFER FROM 7382910045,,313.44,-125850.74
16 Aug 2024,BY TRANSFER-UPI/CR/494149101932/ANITA P/SBIN/rohit@okhdfc/Dr Re--,TRANSFER FROM 4897690162095,,1371.13,-124479.61
30 Sep 2024,TO TRANSFER-UPI/DR/440187418686/ANITA P/SBIN/anitapawar/UPI--,TRANSFER TO 9137022807,658.46,,-125138.07
26 Jul 2024,BY TRANSFER-UPI/CR/450738839184/SAGAR MO/ICIC/rahuldixit/Dr Re--,TRANSFER FROM 9137022807,,3027.35,-122110.72
16 Aug 2024,TO TRANSFER-UPI/DR/467886815218/PRIYA K/KKBK/rahuldixit/UPI--,TRANSFER TO 4897690162095,482.39,,-122593.11
18 Jul 2024,TO TRANSFER-UPI/DR/466133954277/ROHIT T/HDFC/rahuldixit/UPI--,TRANSFER TO 8974521398,3448.74,,-126041.85
18 Jul 2024,BY TRANSFER-UPI/CR/450239423666/RAHUL D/HDFC/write2same/Dr Re--,TRANSFER FROM 4897732162091,,1230.61,-124811.24
21 Aug 2024,BY TRANSFER-UPI/CR/455757224769/MS SANJE/KKBK/anitapawar/Dr Re--,TRANSFER FROM 4897732162091,,1160.11,-123651.13
29 Jul 2024,TO TRANSFER-UPI/DR/477148819028/MS SANJE/ICIC/rahuldixit/UPI--,TRANSFER TO 8974521398,4184.32,,-127835.45
22 Jul 2024,TO TRANSFER-UPI/DR/491220186398/ROHIT T/ICIC/rohit@okhdfc/UPI--,TRANSFER TO 4897690162095,2235.31,,-130070.76
19 Jul 2024,TO TRANSFER-UPI/DR/427263830990/ROHIT T/HDFC/anitapawar/UPI--,TRANSFER TO 8974521398,1761.97,,-131832.73
25 Sep 2024,BY TRANSFER-UPI/CR/418154912924/SAGAR MO/KKBK/rohit@okhdfc/Dr Re--,TRANSFER FROM 7382910045,,3787.16,-128045.57
4 Jul 2024,TO TRANSFER-UPI/DR/452464160595/PRIYA K/KKBK/rahuldixit/UPI--,TRANSFER TO 4897732162091,4905.79,,-132951.36
12 Jul 2024,BY TRANSFER-UPI/CR/447192415012/MS SANJE/IDIB/spawar3290/Dr Re--,TRANSFER FROM 4897690162095,,3939.05,-129012.31
29 Jul 2024,BY TRANSFER-UPI/CR/472254423106/SAMEER S/SBIN/rahuldixit/Dr Re--,TRANSFER FROM 4897732162091,,668.63,-128343.68
22 Jul 2024,TO TRANSFER-UPI/DR/413249468836/SAGAR MO/IDIB/write2same/UPI--,TRANSFER TO 8974521398,3436.18,,-131779.86
4 Sep 2024,BY TRANSFER-UPI/CR/471801200408/SAGAR MO/IDIB/write2same/Dr Re--,TRANSFER FROM 8974521398,,1363.61,-130416.25
26 Jul 2024,BY TRANSFER-UPI/CR/456756314387/SAMEER S/ICIC/rohit@okhdfc/Dr Re--,TRANSFER FROM 4897732162091,,2301.42,-128114.83
15 Sep 2024,TO TRANSFER-UPI/DR/460789722586/MS SANJE/SBIN/rahuldixit/UPI--,TRANSFER TO 4897690162095,4966.67,,-133081.5
1 Sep 2024,BY TRANSFER-UPI/CR/419240425821/MS SANJE/KKBK/write2same/Dr Re--,TRANSFER FROM 4897690162095,,2799.59,-130281.91
13 Jul 2024,TO TRANSFER-UPI/DR/440119678500/MS SANJE/HDFC/spawar3290/UPI--,TRANSFER TO 7382910045,2286.93,,-132568.84
28 Sep 2024,TO TRANSFER-UPI/DR/445672297407/SAMEER S/KKBK/anitapawar/UPI--,TRANSFER TO 7382910045,3250.72,,-135819.56
7 Aug 2024,TO TRANSFER-UPI/DR/408007406810/ROHIT T/ICIC/write2same/UPI--,TRANSFER TO 8974521398,2293.57,,-138113.13
17 Sep 2024,TO TRANSFER-UPI/DR/465074012128/ANITA P/IDIB/anitapawar/UPI--,TRANSFER TO 8974521398,995.85,,-139108.98
21 Jul 2024,TO TRANSFER-UPI/DR/443400146983/ROHIT T/SBIN/write2same/UPI--,TRANSFER TO 9137022807,4776.71,,-143885.69
20 Jul 2024,TO TRANSFER-UPI/DR/401036539142/ROHIT T/HDFC/write2same/UPI--,TRANSFER TO 4897690162095,4870.83,,-148756.52
22 Jul 2024,BY TRANSFER-UPI/CR/422883228905/PRIYA K/SBIN/rohit@okhdfc/Dr Re--,TRANSFER FROM 9137022807,,3522.31,-145234.21
8 Aug 2024,TO TRANSFER-UPI/DR/418484047873/SAMEER S/IDIB/rahuldixit/UPI--,TRANSFER TO 8974521398,3872.4,,-149106.61
11 Aug 2024,TO TRANSFER-UPI/DR/421895201786/ROHIT T/KKBK/rohit@okhdfc/UPI--,TRANSFER TO 8974521398,372.29,,-149478.9
13 Jul 2024,BY TRANSFER-UPI/CR/495088732252/MS SANJE/IDIB/anitapawar/Dr Re--,TRANSFER FROM 7382910045,,125.05,-149353.85
18 Sep 2024,TO TRANSFER-UPI/DR/401761663080/RAHUL D/KKBK/rohit@okhdfc/UPI--,TRANSFER TO 7382910045,2699.04,,-152052.89
25 Aug 2024,BY TRANSFER-UPI/CR/477366527209/SAMEER S/KKBK/spawar3290/Dr Re--,TRANSFER FROM 4897690162095,,112.67,-151940.22
1 Jul 2024,BY TRANSFER-UPI/CR/421291518473/MS SANJE/IDIB/rohit@okhdfc/Dr Re--,TRANSFER FROM 4897690162095,,431.32,-151508.9
6 Sep 2024,TO TRANSFER-UPI/DR/402090758809/SAGAR MO/ICIC/rahuldixit/UPI--,TRANSFER TO 4897690162095,2430.23,,-153939.13
26 Jul 2024,TO TRANSFER-UPI/DR/477870006420/RAHUL D/HDFC/rohit@okhdfc/UPI--,TRANSFER TO 4897732162091,828.37,,-154767.5
28 Sep 2024,BY TRANSFER-UPI/CR/406021338193/RAHUL D/SBIN/write2same/Dr Re--,TRANSFER FROM 4897732162091,,454.22,-154313.28
28 Jul 2024,BY TRANSFER-UPI/CR/403845016161/MS SANJE/IDIB/rahuldixit/Dr Re--,TRANSFER FROM 9137022807,,3437.43,-150875.85
7 Jul 2024,TO TRANSFER-UPI/DR/453534261520/ROHIT T/IDIB/write2same/UPI--,TRANSFER TO 9137022807,3046.91,,-153922.76
23 Jul 2024,TO TRANSFER-UPI/DR/414687874686/PRIYA K/HDFC/write2same/UPI--,TRANSFER TO 9137022807,3203.16,,-157125.92
27 Sep 2024,BY TRANSFER-UPI/CR/422476157315/RAHUL D/ICIC/rohit@okhdfc/Dr Re--,TRANSFER FROM 4897690162095,,4999.63,-152126.29
22 Aug 2024,TO TRANSFER-UPI/DR/474633594094/SAMEER S/ICIC/rohit@okhdfc/UPI--,TRANSFER TO 4897732162091,3896.1,,-156022.39
3 Sep 2024,BY TRANSFER-UPI/CR/462598692100/SAMEER S/ICIC/anitapawar/Dr Re--,TRANSFER FROM 9137022807,,1990.91,-154031.48
7 Aug 2024,BY TRANSFER-UPI/CR/472645331872/PRIYA K/KKBK/rahuldixit/Dr Re--,TRANSFER FROM 8974521398,,4146.56,-149884.92
17 Jul 2024,BY TRANSFER-UPI/CR/454054305541/ROHIT T/KKBK/rohit@okhdfc/Dr Re--,TRANSFER FROM 8974521398,,4377.9,-145507.02
1 Aug 2024,BY TRANSFER-UPI/CR/415869867496/RAHUL D/SBIN/rahuldixit/Dr Re--,TRANSFER FROM 7382910045,,3738.58,-141768.44
14 Jul 2024,TO TRANSFER-UPI/DR/442163178226/ROHIT T/KKBK/rahuldixit/UPI--,TRANSFER TO 4897732162091,1375.87,,-143144.31
2 Sep 2024,TO TRANSFER-UPI/DR/484867428652/ANITA P/SBIN/spawar3290/UPI--,TRANSFER TO 9137022807,339.5,,-143483.81
2 Jul 2024,TO TRANSFER-UPI/DR/482332552169/ANITA P/IDIB/rahuldixit/UPI--,TRANSFER TO 4897732162091,2937.22,,-146421.03
26 Jul 2024,TO TRANSFER-UPI/DR/430835868287/RAHUL D/SBIN/spawar3290/UPI--,TRANSFER TO 4897732162091,1644.82,,-148065.85
12 Sep 2024,TO TRANSFER-UPI/DR/408726113016/SAGAR MO/HDFC/rahuldixit/UPI--,TRANSFER TO 4897690162095,2103.2,,-150169.05
30 Sep 2024,TO TRANSFER-UPI/DR/469451828411/RAHUL D/SBIN/rahuldixit/UPI--,TRANSFER TO 8974521398,4167.3,,-154336.35
26 Jul 2024,BY TRANSFER-UPI/CR/425623637839/ROHIT T/ICIC/write2same/Dr Re--,TRANSFER FROM 9137022807,,4741.78,-149594.57
15 Sep 2024,TO TRANSFER-UPI/DR/405298885659/SAGAR MO/KKBK/spawar3290/UPI--,TRANSFER TO 4897732162091,515.95,,-150110.52
22 Aug 2024,BY TRANSFER-UPI/CR/418141492974/MS SANJE/ICIC/write2same/Dr Re--,TRANSFER FROM 4897732162091,,3955.68,-146154.84
28 Sep 2024,TO TRANSFER-UPI/DR/485573408136/PRIYA K/ICIC/rahuldixit/UPI--,TRANSFER TO 9137022807,3572.65,,-149727.49
1 Jul 2024,BY TRANSFER-UPI/CR/476346395368/ROHIT T/ICIC/spawar3290/Dr Re--,TRANSFER FROM 4897690162095,,2015.74,-147711.75
18 Jul 2024,TO TRANSFER-UPI/DR/473088244713/ANITA P/SBIN/anitapawar/UPI--,TRANSFER TO 4897690162095,1111.02,,-148822.77
25 Jul 2024,BY TRANSFER-UPI/CR/437074237717/PRIYA K/KKBK/rohit@okhdfc/Dr Re--,TRANSFER FROM 7382910045,,4630.8,-144191.97
26 Jul 2024,BY TRANSFER-UPI/CR/446630158725/MS SANJE/KKBK/write2same/Dr Re--,TRANSFER FROM 8974521398,,2834.85,-141357.12
6 Jul 2024,TO TRANSFER-UPI/DR/453212893258/ROHIT T/ICIC/write2same/UPI--,TRANSFER TO 4897732162091,4899.82,,-146256.94
25 Aug 2024,BY TRANSFER-UPI/CR/425459586324/SAGAR MO/ICIC/spawar3290/Dr Re--,TRANSFER FROM 7382910045,,1449.44,-144807.5
19 Aug 2024,TO TRANSFER-UPI/DR/463223108145/PRIYA K/KKBK/rahuldixit/UPI--,TRANSFER TO 8974521398,4709.06,,-149516.56
8 Sep 2024,TO TRANSFER-UPI/DR/431191516105/MS SANJE/HDFC/rahuldixit/UPI--,TRANSFER TO 8974521398,1293.34,,-150809.9
17 Jul 2024,TO TRANSFER-UPI/DR/457272377933/SAGAR MO/HDFC/spawar3290/UPI--,TRANSFER TO 4897690162095,2687.99,,-153497.89
1 Jul 2024,BY TRANSFER-UPI/CR/445809632267/RAHUL D/IDIB/anitapawar/Dr Re--,TRANSFER FROM 9137022807,,3713.47,-149784.42
30 Sep 2024,BY TRANSFER-UPI/CR/427720636561/RAHUL D/KKBK/rahuldixit/Dr Re--,TRANSFER FROM 8974521398,,3203.63,-146580.79
1 Sep 2024,TO TRANSFER-UPI/DR/490900080009/RAHUL D/SBIN/rohit@okhdfc/UPI--,TRANSFER TO 7382910045,1189.22,,-147770.01
15 Sep 2024,TO TRANSFER-UPI/DR/400421052436/MS SANJE/IDIB/rahuldixit/UPI--,TRANSFER TO 7382910045,1580.5,,-149350.51
20 Sep 2024,TO TRANSFER-UPI/DR/495338700405/ROHIT T/HDFC/spawar3290/UPI--,TRANSFER TO 4897690162095,4276.8,,-153627.31
7 Jul 2024,BY TRANSFER-UPI/CR/427369433637/ANITA P/HDFC/rahuldixit/Dr Re--,TRANSFER FROM 7382910045,,4896.89,-148730.42
28 Jul 2024,TO TRANSFER-UPI/DR/482526270796/ANITA P/SBIN/rahuldixit/UPI--,TRANSFER TO 4897690162095,2211.62,,-150942.04
5 Jul 2024,TO TRANSFER-UPI/DR/435263629267/MS SANJE/HDFC/rohit@okhdfc/UPI--,TRANSFER TO 4897690162095,4306.4,,-155248.44
31 Jul 2024,TO TRANSFER-UPI/DR/429242831729/SAGAR MO/IDIB/spawar3290/UPI--,TRANSFER TO 9137022807,2753.76,,-158002.2
25 Aug 2024,BY TRANSFER-UPI/CR/473260232506/SAGAR MO/KKBK/anitapawar/Dr Re--,TRANSFER FROM 7382910045,,2518.81,-155483.39
20 Jul 2024,BY TRANSFER-UPI/CR/468583018937/ANITA P/KKBK/anitapawar/Dr Re--,TRANSFER FROM 9137022807,,2623.59,-152859.8
8 Jul 2024,BY TRANSFER-UPI/CR/428660760597/SAGAR MO/KKBK/write2same/Dr Re--,TRANSFER FROM 4897732162091,,526.89,-152332.91
30 Aug 2024,TO TRANSFER-UPI/DR/412987568970/ROHIT T/SBIN/spawar3290/UPI--,TRANSFER TO 9137022807,4244.62,,-156577.53
10 Aug 2024,BY TRANSFER-UPI/CR/434954505226/PRIYA K/KKBK/rohit@okhdfc/Dr Re--,TRANSFER FROM 4897732162091,,4835.63,-151741.9
3 Jul 2024,BY TRANSFER-UPI/CR/438396723867/RAHUL D/HDFC/spawar3290/Dr Re--,TRANSFER FROM 9137022807,,1758.04,-149983.86
12 Sep 2024,BY TRANSFER-UPI/CR/421195644627/MS SANJE/IDIB/write2same/Dr Re--,TRANSFER FROM 4897732162091,,3800.85,-146183.01
18 Aug 2024,BY TRANSFER-UPI/CR/433315032821/ROHIT T/HDFC/spawar3290/Dr Re--,TRANSFER FROM 7382910045,,3109.76,-143073.25
7 Jul 2024,TO TRANSFER-UPI/DR/486008529841/ROHIT T/IDIB/rohit@okhdfc/UPI--,TRANSFER TO 8974521398,1863.22,,-144936.47
16 Jul 2024,TO TRANSFER-UPI/DR/490904488033/ROHIT T/IDIB/spawar3290/UPI--,TRANSFER TO 7382910045,1908.73,,-146845.2
17 Sep 2024,BY TRANSFER-UPI/CR/478454118782/SAMEER S/IDIB/rohit@okhdfc/Dr Re--,TRANSFER FROM 4897732162091,,3794.99,-143050.21
27 Jul 2024,TO TRANSFER-UPI/DR/430592217801/SAGAR MO/IDIB/rahuldixit/UPI--,TRANSFER TO 8974521398,2239.49,,-145289.7
17 Jul 2024,BY TRANSFER-UPI/CR/470876112044/RAHUL D/HDFC/rahuldixit/Dr Re--,TRANSFER FROM 9137022807,,2154.43,-143135.27
26 Aug 2024,TO TRANSFER-UPI/DR/439296595427/SAGAR MO/SBIN/rohit@okhdfc/UPI--,TRANSFER TO 4897690162095,2226.35,,-145361.62
8 Aug 2024,BY TRANSFER-UPI/CR/426747461874/SAMEER S/IDIB/write2same/Dr Re--,TRANSFER FROM 9137022807,,2498.52,-142863.1
3 Sep 2024,TO TRANSFER-UPI/DR/412368176980/ANITA P/KKBK/write2same/UPI--,TRANSFER TO 4897690162095,2894.19,,-145757.29
10 Aug 2024,TO TRANSFER-UPI/DR/489028292444/PRIYA K/KKBK/rohit@okhdfc/UPI--,TRANSFER TO 8974521398,4859.97,,-150617.26
5 Sep 2024,TO TRANSFER-UPI/DR/453820701051/SAMEER S/ICIC/anitapawar/UPI--,TRANSFER TO 7382910045,4177.38,,-154794.64
5 Jul 2024,BY TRANSFER-UPI/CR/417523717182/SAMEER S/IDIB/write2same/Dr Re--,TRANSFER FROM 8974521398,,3796.87,-150997.77
29 Jul 2024,BY TRANSFER-UPI/CR/422897067739/SAMEER S/IDIB/write2same/Dr Re--,TRANSFER FROM 7382910045,,276.57,-150721.2
5 Aug 2024,TO TRANSFER-UPI/DR/494022829699/ROHIT T/ICIC/anitapawar/UPI--,TRANSFER TO 4897732162091,1297.88,,-152019.08
3 Jul 2024,BY TRANSFER-UPI/CR/421913620353/PRIYA K/ICIC/rohit@okhdfc/Dr Re--,TRANSFER FROM 4897690162095,,4249.73,-147769.35
29 Sep 2024,TO TRANSFER-UPI/DR/416795385264/RAHUL D/IDIB/write2same/UPI--,TRANSFER TO 7382910045,1905.73,,-149675.08
7 Jul 2024,TO TRANSFER-UPI/DR/414594666288/MS SANJE/SBIN/spawar3290/UPI--,TRANSFER TO 4897690162095,4537.18,,-154212.26
5 Jul 2024,BY TRANSFER-UPI/CR/400891276407/ROHIT T/HDFC/anitapawar/Dr Re--,TRANSFER FROM 4897690162095,,1495.03,-152717.23
27 Sep 2024,TO TRANSFER-UPI/DR/469988207645/MS SANJE/ICIC/write2same/UPI--,TRANSFER TO 8974521398,3391.37,,-156108.6
28 Jul 2024,TO TRANSFER-UPI/DR/422710494706/SAGAR MO/IDIB/anitapawar/UPI--,TRANSFER TO 8974521398,3630.76,,-159739.36
21 Jul 2024,BY TRANSFER-UPI/CR/444369587328/PRIYA K/ICIC/rohit@okhdfc/Dr Re--,TRANSFER FROM 4897690162095,,80.87,-159658.49
7 Aug 2024,TO TRANSFER-UPI/DR/451782736123/RAHUL D/ICIC/rahuldixit/UPI--,TRANSFER TO 9137022807,4282.67,,-163941.16
8 Jul 2024,BY TRANSFER-UPI/CR/464694391896/PRIYA K/SBIN/anitapawar/Dr Re--,TRANSFER FROM 7382910045,,1288.52,-162652.64
28 Aug 2024,BY TRANSFER-UPI/CR/437430794753/MS SANJE/SBIN/rahuldixit/Dr Re--,TRANSFER FROM 8974521398,,803.66,-161848.98
20 Aug 2024,BY TRANSFER-UPI/CR/479153205533/ROHIT T/KKBK/rohit@okhdfc/Dr Re--,TRANSFER FROM 9137022807,,1902.6,-159946.38
27 Aug 2024,TO TRANSFER-UPI/DR/414994468403/ANITA P/IDIB/spawar3290/UPI--,TRANSFER TO 9137022807,3040.97,,-162987.35
16 Jul 2024,TO TRANSFER-UPI/DR/465262782222/ROHIT T/SBIN/anitapawar/UPI--,TRANSFER TO 4897732162091,2645.08,,-165632.43
13 Aug 2024,TO TRANSFER-UPI/DR/458658010547/SAMEER S/SBIN/rohit@okhdfc/UPI--,TRANSFER TO 8974521398,4394.61,,-170027.04
30 Sep 2024,TO TRANSFER-UPI/DR/460393712060/ROHIT T/SBIN/write2same/UPI--,TRANSFER TO 8974521398,1155.72,,-171182.76
7 Aug 2024,BY TRANSFER-UPI/CR/421641490460/SAGAR MO/HDFC/rahuldixit/Dr Re--,TRANSFER FROM 9137022807,,2233.28,-168949.48
23 Aug 2024,TO TRANSFER-UPI/DR/410648976070/SAMEER S/IDIB/rahuldixit/UPI--,TRANSFER TO 9137022807,396.55,,-169346.03
14 Aug 2024,TO TRANSFER-UPI/DR/431934814041/PRIYA K/SBIN/anitapawar/UPI--,TRANSFER TO 8974521398,270.35,,-169616.38
16 Jul 2024,BY TRANSFER-UPI/CR/426536557923/SAMEER S/ICIC/spawar3290/Dr Re--,TRANSFER FROM 4897690162095,,4628.61,-164987.77
3 Jul 2024,BY TRANSFER-UPI/CR/468248591928/PRIYA K/HDFC/write2same/Dr Re--,TRANSFER FROM 4897732162091,,4722.64,-160265.13
29 Aug 2024,BY TRANSFER-UPI/CR/421723843973/PRIYA K/KKBK/rahuldixit/Dr Re--,TRANSFER FROM 4897690162095,,863.31,-159401.82
10 Sep 2024,BY TRANSFER-UPI/CR/481935628856/MS SANJE/IDIB/spawar3290/Dr Re--,TRANSFER FROM 8974521398,,447.23,-158954.59
13 Jul 2024,TO TRANSFER-UPI/DR/430419966393/ROHIT T/IDIB/anitapawar/UPI--,TRANSFER TO 4897690162095,3886.9,,-162841.49
3 Aug 2024,TO TRANSFER-UPI/DR/496081071144/PRIYA K/IDIB/anitapawar/UPI--,TRANSFER TO 7382910045,3292.96,,-166134.45
18 Sep 2024,BY TRANSFER-UPI/CR/472885409027/RAHUL D/SBIN/spawar3290/Dr Re--,TRANSFER FROM 4897732162091,,424.05,-165710.4
2 Sep 2024,TO TRANSFER-UPI/DR/470553667540/ANITA P/ICIC/spawar3290/UPI--,TRANSFER TO 4897732162091,3581.21,,-169291.61
1 Jul 2024,BY TRANSFER-UPI/CR/448043062435/PRIYA K/KKBK/anitapawar/Dr Re--,TRANSFER FROM 8974521398,,3199.8,-166091.81
5 Sep 2024,BY TRANSFER-UPI/CR/428701744105/MS SANJE/HDFC/spawar3290/Dr Re--,TRANSFER FROM 7382910045,,306.67,-165785.14
11 Aug 2024,TO TRANSFER-UPI/DR/438831946622/SAGAR MO/KKBK/write2same/UPI--,TRANSFER TO 4897690162095,3067.27,,-168852.41
1 Jul 2024,BY TRANSFER-UPI/CR/461013311675/MS SANJE/KKBK/write2same/Dr Re--,TRANSFER FROM 4897690162095,,321.63,-168530.78
5 Aug 2024,TO TRANSFER-UPI/DR/498539264969/PRIYA K/KKBK/anitapawar/UPI--,TRANSFER TO 9137022807,595.25,,-169126.03
7 Aug 2024,BY TRANSFER-UPI/CR/460230360445/PRIYA K/HDFC/rohit@okhdfc/Dr Re--,TRANSFER FROM 9137022807,,1217.85,-167908.18
1 Aug 2024,BY TRANSFER-UPI/CR/462712093068/MS SANJE/IDIB/write2same/Dr Re--,TRANSFER FROM 9137022807,,946.66,-166961.52
21 Aug 2024,TO TRANSFER-UPI/DR/430736903290/RAHUL D/ICIC/anitapawar/UPI--,TRANSFER TO 7382910045,3999.88,,-170961.4
4 Sep 2024,TO TRANSFER-UPI/DR/448771926221/PRIYA K/IDIB/write2same/UPI--,TRANSFER TO 4897690162095,2952.33,,-173913.73
13 Aug 2024,TO TRANSFER-UPI/DR/403769173956/ANITA P/SBIN/anitapawar/UPI--,TRANSFER TO 9137022807,3015.48,,-176929.21
21 Sep 2024,TO TRANSFER-UPI/DR/481051353129/RAHUL D/IDIB/rahuldixit/UPI--,TRANSFER TO 7382910045,1801.08,,-178730.29
23 Sep 2024,BY TRANSFER-UPI/CR/447471879548/SAMEER S/SBIN/rohit@okhdfc/Dr Re--,TRANSFER FROM 9137022807,,2062.93,-176667.36
24 Jul 2024,TO TRANSFER-UPI/DR/440877948218/MS SANJE/KKBK/rohit@okhdfc/UPI--,TRANSFER TO 7382910045,2771.52,,-179438.88
21 Aug 2024,TO TRANSFER-UPI/DR/447639978054/RAHUL D/SBIN/spawar3290/UPI--,TRANSFER TO 7382910045,192.33,,-179631.21
15 Aug 2024,TO TRANSFER-UPI/DR/413455176968/PRIYA K/IDIB/spawar3290/UPI--,TRANSFER TO 4897732162091,4904.01,,-184535.22
19 Aug 2024,BY TRANSFER-UPI/CR/405413406080/SAMEER S/SBIN/anitapawar/Dr Re--,TRANSFER FROM 7382910045,,616.05,-183919.17
23 Aug 2024,TO TRANSFER-UPI/DR/408570906514/MS SANJE/KKBK/spawar3290/UPI--,TRANSFER TO 8974521398,2613.09,,-186532.26
20 Sep 2024,BY TRANSFER-UPI/CR/423043834973/ANITA P/ICIC/spawar3290/Dr Re--,TRANSFER FROM 8974521398,,567.84,-185964.42
21 Jul 2024,TO TRANSFER-UPI/DR/491810538067/ROHIT T/KKBK/write2same/UPI--,TRANSFER TO 4897732162091,2169.26,,-188133.68
19 Aug 2024,TO TRANSFER-UPI/DR/447552138542/MS SANJE/IDIB/write2same/UPI--,TRANSFER TO 9137022807,4357.9,,-192491.58
8 Jul 2024,TO TRANSFER-UPI/DR/481703661769/MS SANJE/KKBK/anitapawar/UPI--,TRANSFER TO 8974521398,2293.82,,-194785.4
18 Aug 2024,TO TRANSFER-UPI/DR/447203860607/RAHUL D/SBIN/rohit@okhdfc/UPI--,TRANSFER TO 4897732162091,2077.81,,-196863.21
3 Sep 2024,BY TRANSFER-UPI/CR/454603866638/MS SANJE/ICIC/rahuldixit/Dr Re--,TRANSFER FROM 9137022807,,2112.87,-194750.34
8 Sep 2024,BY TRANSFER-UPI/CR/463646613329/ROHIT T/KKBK/anitapawar/Dr Re--,TRANSFER FROM 4897732162091,,1847.53,-192902.81
25 Aug 2024,BY TRANSFER-UPI/CR/464858634957/ANITA P/ICIC/write2same/Dr Re--,TRANSFER FROM 4897732162091,,1469.04,-191433.77
15 Aug 2024,TO TRANSFER-UPI/DR/442988784017/SAGAR MO/ICIC/write2same/UPI--,TRANSFER TO 4897690162095,581.51,,-192015.28
13 Aug 2024,BY TRANSFER-UPI/CR/415648240828/ROHIT T/HDFC/write2same/Dr Re--,TRANSFER FROM 4897690162095,,1255.17,-190760.11
31 Aug 2024,BY TRANSFER-UPI/CR/457210778259/MS SANJE/IDIB/rohit@okhdfc/Dr Re--,TRANSFER FROM 9137022807,,1127.36,-189632.75
2 Jul 2024,TO TRANSFER-UPI/DR/438970662881/SAGAR MO/SBIN/write2same/UPI--,TRANSFER TO 8974521398,1501.97,,-191134.72
21 Aug 2024,BY TRANSFER-UPI/CR/425458339771/ANITA P/ICIC/rahuldixit/Dr Re--,TRANSFER FROM 4897732162091,,4935.04,-186199.68
21 Jul 2024,BY TRANSFER-UPI/CR/457818316479/SAMEER S/ICIC/rahuldixit/Dr Re--,TRANSFER FROM 4897732162091,,2845.53,-183354.15
31 Aug 2024,TO TRANSFER-UPI/DR/494635903303/MS SANJE/IDIB/anitapawar/UPI--,TRANSFER TO 4897690162095,1863.92,,-185218.07
8 Sep 2024,TO TRANSFER-UPI/DR/453184557720/SAGAR MO/SBIN/rahuldixit/UPI--,TRANSFER TO 7382910045,573.92,,-185791.99
18 Sep 2024,TO TRANSFER-UPI/DR/441683886965/ANITA P/ICIC/anitapawar/UPI--,TRANSFER TO 4897732162091,3793.82,,-189585.81
31 Aug 2024,BY TRANSFER-UPI/CR/418450410347/SAMEER S/IDIB/anitapawar/Dr Re--,TRANSFER FROM 4897732162091,,4937.8,-184648.01
26 Sep 2024,TO TRANSFER-UPI/DR/403852182455/MS SANJE/HDFC/write2same/UPI--,TRANSFER TO 4897732162091,1793.86,,-186441.87
3 Aug 2024,TO TRANSFER-UPI/DR/414538619622/MS SANJE/ICIC/rahuldixit/UPI--,TRANSFER TO 4897732162091,1213.57,,-187655.44
8 Jul 2024,BY TRANSFER-UPI/CR/494378113514/ANITA P/KKBK/spawar3290/Dr Re--,TRANSFER FROM 4897732162091,,2741.98,-184913.46
7 Sep 2024,TO TRANSFER-UPI/DR/453594437158/PRIYA K/HDFC/rahuldixit/UPI--,TRANSFER TO 9137022807,774.08,,-185687.54
3 Sep 2024,BY TRANSFER-UPI/CR/465266325880/RAHUL D/KKBK/write2same/Dr Re--,TRANSFER FROM 4897690162095,,4547.91,-181139.63
21 Jul 2024,TO TRANSFER-UPI/DR/429476105971/SAMEER S/KKBK/spawar3290/UPI--,TRANSFER TO 4897732162091,1334.62,,-182474.25
23 Sep 2024,BY TRANSFER-UPI/CR/417615940658/SAMEER S/ICIC/anitapawar/Dr Re--,TRANSFER FROM 4897732162091,,3458.78,-179015.47
1 Jul 2024,BY TRANSFER-UPI/CR/453086473882/ANITA P/SBIN/anitapawar/Dr Re--,TRANSFER FROM 4897690162095,,3826.5,-175188.97
24 Sep 2024,TO TRANSFER-UPI/DR/464033565555/SAGAR MO/HDFC/write2same/UPI--,TRANSFER TO 4897690162095,3002.46,,-178191.43
21 Jul 2024,TO TRANSFER-UPI/DR/478466185826/SAGAR MO/IDIB/spawar3290/UPI--,TRANSFER TO 4897690162095,2373.56,,-180564.99
4 Aug 2024,BY TRANSFER-UPI/CR/466849836237/MS SANJE/ICIC/spawar3290/Dr Re--,TRANSFER FROM 8974521398,,2857.98,-177707.01
30 Aug 2024,TO TRANSFER-UPI/DR/464897493820/RAHUL D/IDIB/rohit@okhdfc/UPI--,TRANSFER TO 4897732162091,973.93,,-178680.94
26 Aug 2024,TO TRANSFER-UPI/DR/402350917278/SAGAR MO/HDFC/rahuldixit/UPI--,TRANSFER TO 8974521398,1970.94,,-180651.88
2 Jul 2024,TO TRANSFER-UPI/DR/405163661741/ROHIT T/KKBK/rohit@okhdfc/UPI--,TRANSFER TO 9137022807,3004.24,,-183656.12
9 Jul 2024,BY TRANSFER-UPI/CR/445560832981/RAHUL D/HDFC/anitapawar/Dr Re--,TRANSFER FROM 9137022807,,2635.03,-181021.09
29 Sep 2024,BY TRANSFER-UPI/CR/404060700080/SAMEER S/SBIN/spawar3290/Dr Re--,TRANSFER FROM 4897690162095,,3341.79,-177679.3
30 Jul 2024,TO TRANSFER-UPI/DR/459015414495/SAGAR MO/ICIC/anitapawar/UPI--,TRANSFER TO 4897690162095,331.89,,-178011.19
27 Aug 2024,BY TRANSFER-UPI/CR/453992294692/SAMEER S/HDFC/anitapawar/Dr Re--,TRANSFER FROM 4897690162095,,3000.24,-175010.95
13 Aug 2024,TO TRANSFER-UPI/DR/464024146816/PRIYA K/KKBK/rahuldixit/UPI--,TRANSFER TO 4897690162095,4525.77,,-179536.72
14 Aug 2024,TO TRANSFER-UPI/DR/409296131319/ANITA P/IDIB/rahuldixit/UPI--,TRANSFER TO 9137022807,1283.3,,-180820.02
10 Sep 2024,BY TRANSFER-UPI/CR/498255229623/SAMEER S/HDFC/rohit@okhdfc/Dr Re--,TRANSFER FROM 9137022807,,1424.12,-179395.9
14 Aug 2024,TO TRANSFER-UPI/DR/475738576145/ROHIT T/HDFC/rohit@okhdfc/UPI--,TRANSFER TO 4897732162091,924.1,,-180320.0
10 Aug 2024,TO TRANSFER-UPI/DR/414562491518/MS SANJE/ICIC/rohit@okhdfc/UPI--,TRANSFER TO 7382910045,2582.12,,-182902.12
26 Sep 2024,TO TRANSFER-UPI/DR/419563709834/PRIYA K/KKBK/anitapawar/UPI--,TRANSFER TO 9137022807,4430.26,,-187332.38
28 Jul 2024,BY TRANSFER-UPI/CR/494681968596/ROHIT T/KKBK/rohit@okhdfc/Dr Re--,TRANSFER FROM 4897732162091,,3916.87,-183415.51
15 Aug 2024,BY TRANSFER-UPI/CR/487271451686/RAHUL D/IDIB/rahuldixit/Dr Re--,TRANSFER FROM 4897732162091,,2240.54,-181174.97
2 Jul 2024,TO TRANSFER-UPI/DR/461029006379/SAGAR MO/ICIC/write2same/UPI--,TRANSFER TO 7382910045,565.72,,-181740.69
16 Sep 2024,TO TRANSFER-UPI/DR/497145273562/MS SANJE/SBIN/spawar3290/UPI--,TRANSFER TO 4897732162091,4939.11,,-186679.8
18 Jul 2024,TO TRANSFER-UPI/DR/407296091431/ROHIT T/HDFC/anitapawar/UPI--,TRANSFER TO 8974521398,319.6,,-186999.4
2 Jul 2024,TO TRANSFER-UPI/DR/447296970518/ROHIT T/SBIN/rahuldixit/UPI--,TRANSFER TO 9137022807,1659.02,,-188658.42
28 Sep 2024,TO TRANSFER-UPI/DR/476581394191/ROHIT T/IDIB/write2same/UPI--,TRANSFER TO 9137022807,4915.51,,-193573.93
19 Aug 2024,TO TRANSFER-UPI/DR/492275868351/ANITA P/IDIB/write2same/UPI--,TRANSFER TO 7382910045,4754.8,,-198328.73
22 Jul 2024,BY TRANSFER-UPI/CR/460174732923/RAHUL D/ICIC/rahuldixit/Dr Re--,TRANSFER FROM 7382910045,,2394.84,-195933.89
6 Aug 2024,BY TRANSFER-UPI/CR/494191483375/SAMEER S/SBIN/spawar3290/Dr Re--,TRANSFER FROM 8974521398,,1181.66,-194752.23
20 Jul 2024,TO TRANSFER-UPI/DR/452378548887/PRIYA K/IDIB/rahuldixit/UPI--,TRANSFER TO 4897732162091,4584.56,,-199336.79
3 Sep 2024,BY TRANSFER-UPI/CR/415382887799/ANITA P/KKBK/spawar3290/Dr Re--,TRANSFER FROM 8974521398,,2863.77,-196473.02
20 Jul 2024,BY TRANSFER-UPI/CR/472452975180/RAHUL D/IDIB/rahuldixit/Dr Re--,TRANSFER FROM 4897732162091,,1257.68,-195215.34
10 Aug 2024,TO TRANSFER-UPI/DR/434448684658/ROHIT T/HDFC/write2same/UPI--,TRANSFER TO 8974521398,2139.06,,-197354.4
29 Aug 2024,TO TRANSFER-UPI/DR/454314766589/ANITA P/IDIB/write2same/UPI--,TRANSFER TO 4897732162091,3108.28,,-200462.68
19 Jul 2024,BY TRANSFER-UPI/CR/445974068736/ANITA P/IDIB/rohit@okhdfc/Dr Re--,TRANSFER FROM 8974521398,,1026.0,-199436.68
3 Sep 2024,TO TRANSFER-UPI/DR/490475606819/SAGAR MO/SBIN/rohit@okhdfc/UPI--,TRANSFER TO 7382910045,4068.37,,-203505.05
2 Sep 2024,BY TRANSFER-UPI/CR/421819006285/MS SANJE/ICIC/rahuldixit/Dr Re--,TRANSFER FROM 4897732162091,,2935.48,-200569.57
23 Sep 2024,BY TRANSFER-UPI/CR/479801868852/PRIYA K/ICIC/spawar3290/Dr Re--,TRANSFER FROM 8974521398,,90.8,-200478.77
13 Aug 2024,BY TRANSFER-UPI/CR/462974114700/PRIYA K/HDFC/rohit@okhdfc/Dr Re--,TRANSFER FROM 8974521398,,2998.09,-197480.68
2 Jul 2024,TO TRANSFER-UPI/DR/487934132946/MS SANJE/ICIC/spawar3290/UPI--,TRANSFER TO 8974521398,3855.93,,-201336.61
18 Aug 2024,TO TRANSFER-UPI/DR/412657054765/SAGAR MO/ICIC/rahuldixit/UPI--,TRANSFER TO 4897690162095,778.23,,-202114.84
24 Sep 2024,BY TRANSFER-UPI/CR/491381145374/PRIYA K/KKBK/write2same/Dr Re--,TRANSFER FROM 8974521398,,156.28,-201958.56
28 Jul 2024,TO TRANSFER-UPI/DR/457163770977/MS SANJE/ICIC/anitapawar/UPI--,TRANSFER TO 4897732162091,1158.95,,-203117.51
13 Sep 2024,BY TRANSFER-UPI/CR/404475981498/PRIYA K/HDFC/write2same/Dr Re--,TRANSFER FROM 8974521398,,4162.95,-198954.56
1 Jul 2024,BY TRANSFER-UPI/CR/425035189096/SAMEER S/IDIB/rohit@okhdfc/Dr Re--,TRANSFER FROM 4897690162095,,2860.5,-196094.06
7 Sep 2024,TO TRANSFER-UPI/DR/419159366415/SAMEER S/IDIB/rohit@okhdfc/UPI--,TRANSFER TO 4897690162095,287.4,,-196381.46
23 Aug 2024,BY TRANSFER-UPI/CR/457157288252/ROHIT T/KKBK/spawar3290/Dr Re--,TRANSFER FROM 9137022807,,1001.57,-195379.89
3 Sep 2024,TO TRANSFER-UPI/DR/427081148676/PRIYA K/SBIN/anitapawar/UPI--,TRANSFER TO 7382910045,3674.2,,-199054.09
19 Sep 2024,TO TRANSFER-UPI/DR/420480218357/RAHUL D/SBIN/spawar3290/UPI--,TRANSFER TO 9137022807,3653.84,,-202707.93
14 Sep 2024,BY TRANSFER-UPI/CR/471337250629/MS SANJE/IDIB/rohit@okhdfc/Dr Re--,TRANSFER FROM 4897732162091,,4358.93,-198349.0
6 Aug 2024,TO TRANSFER-UPI/DR/415806751033/SAGAR MO/ICIC/write2same/UPI--,TRANSFER TO 4897690162095,681.08,,-199030.08
14 Aug 2024,BY TRANSFER-UPI/CR/408182478476/MS SANJE/SBIN/anitapawar/Dr Re--,TRANSFER FROM 4897690162095,,2289.95,-196740.13
14 Sep 2024,BY TRANSFER-UPI/CR/413323190843/ANITA P/ICIC/rahuldixit/Dr Re--,TRANSFER FROM 9137022807,,818.12,-195922.01
5 Sep 2024,BY TRANSFER-UPI/CR/449535157586/SAGAR MO/KKBK/write2same/Dr Re--,TRANSFER FROM 9137022807,,1432.43,-194489.58
26 Jul 2024,TO TRANSFER-UPI/DR/497452661317/SAGAR MO/KKBK/rohit@okhdfc/UPI--,TRANSFER TO 4897690162095,1403.32,,-195892.9
21 Sep 2024,BY TRANSFER-UPI/CR/407635371071/MS SANJE/IDIB/anitapawar/Dr Re--,TRANSFER FROM 9137022807,,2701.79,-193191.11
11 Jul 2024,BY TRANSFER-UPI/CR/484726266218/SAMEER S/ICIC/rohit@okhdfc/Dr Re--,TRANSFER FROM 9137022807,,506.81,-192684.3
25 Sep 2024,BY TRANSFER-UPI/CR/464575861699/ANITA P/HDFC/write2same/Dr Re--,TRANSFER FROM 9137022807,,304.9,-192379.4
1 Aug 2024,BY TRANSFER-UPI/CR/479399835996/SAGAR MO/SBIN/spawar3290/Dr Re--,TRANSFER FROM 4897690162095,,160.86,-192218.54
20 Aug 2024,TO TRANSFER-UPI/DR/415348027345/ROHIT T/IDIB/anitapawar/UPI--,TRANSFER TO 7382910045,880.17,,-193098.71
25 Aug 2024,TO TRANSFER-UPI/DR/439021898763/ROHIT T/KKBK/rahuldixit/UPI--,TRANSFER TO 9137022807,2232.98,,-195331.69
7 Sep 2024,TO TRANSFER-UPI/DR/475292309064/MS SANJE/HDFC/rohit@okhdfc/UPI--,TRANSFER TO 4897690162095,3211.04,,-198542.73
13 Sep 2024,TO TRANSFER-UPI/DR/459962810441/SAGAR MO/IDIB/anitapawar/UPI--,TRANSFER TO 4897690162095,258.06,,-198800.79
6 Jul 2024,TO TRANSFER-UPI/DR/411120512515/MS SANJE/ICIC/write2same/UPI--,TRANSFER TO 8974521398,613.53,,-199414.32
21 Jul 2024,TO TRANSFER-UPI/DR/409544774558/RAHUL D/SBIN/write2same/UPI--,TRANSFER TO 8974521398,944.5,,-200358.82
19 Jul 2024,TO TRANSFER-UPI/DR/429235165622/RAHUL D/ICIC/rohit@okhdfc/UPI--,TRANSFER TO 9137022807,4203.57,,-204562.39
28 Jul 2024,TO TRANSFER-UPI/DR/405671210894/MS SANJE/ICIC/spawar3290/UPI--,TRANSFER TO 4897690162095,4715.38,,-209277.77
3 Sep 2024,TO TRANSFER-UPI/DR/420355012076/ROHIT T/HDFC/rohit@okhdfc/UPI--,TRANSFER TO 4897690162095,2439.73,,-211717.5
8 Sep 2024,BY TRANSFER-UPI/CR/421676152945/SAGAR MO/HDFC/write2same/Dr Re--,TRANSFER FROM 4897732162091,,1349.31,-210368.19
29 Jul 2024,BY TRANSFER-UPI/CR/458560231591/ANITA P/HDFC/write2same/Dr Re--,TRANSFER FROM 9137022807,,3168.29,-207199.9
12 Sep 2024,TO TRANSFER-UPI/DR/411473513593/ANITA P/IDIB/anitapawar/UPI--,TRANSFER TO 4897732162091,1263.85,,-208463.75
25 Sep 2024,TO TRANSFER-UPI/DR/414863340169/ANITA P/ICIC/rahuldixit/UPI--,TRANSFER TO 7382910045,148.38,,-208612.13
2 Sep 2024,BY TRANSFER-UPI/CR/457649569682/ROHIT T/ICIC/spawar3290/Dr Re--,TRANSFER FROM 9137022807,,1113.6,-207498.53
23 Jul 2024,TO TRANSFER-UPI/DR/449976095499/MS SANJE/HDFC/rohit@okhdfc/UPI--,TRANSFER TO 7382910045,3314.52,,-210813.05
23 Jul 2024,TO TRANSFER-UPI/DR/438353793043/RAHUL D/SBIN/rahuldixit/UPI--,TRANSFER TO 4897732162091,1928.64,,-212741.69
1 Aug 2024,TO TRANSFER-UPI/DR/426469917684/RAHUL D/HDFC/write2same/UPI--,TRANSFER TO 4897690162095,769.42,,-213511.11
6 Sep 2024,BY TRANSFER-UPI/CR/420066959945/SAGAR MO/HDFC/rahuldixit/Dr Re--,TRANSFER FROM 4897732162091,,2244.31,-211266.8
2 Sep 2024,TO TRANSFER-UPI/DR/459095924450/SAGAR MO/IDIB/write2same/UPI--,TRANSFER TO 7382910045,3441.73,,-214708.53
1 Aug 2024,TO TRANSFER-UPI/DR/480539241543/RAHUL D/HDFC/spawar3290/UPI--,TRANSFER TO 8974521398,3979.56,,-218688.09
28 Aug 2024,BY TRANSFER-UPI/CR/457028909845/RAHUL D/HDFC/write2same/Dr Re--,TRANSFER FROM 8974521398,,4323.85,-214364.24
18 Jul 2024,TO TRANSFER-UPI/DR/433037929659/RAHUL D/IDIB/rahuldixit/UPI--,TRANSFER TO 4897690162095,1284.68,,-215648.92
14 Aug 2024,TO TRANSFER-UPI/DR/459641300627/ROHIT T/HDFC/rahuldixit/UPI--,TRANSFER TO 7382910045,506.73,,-216155.65
24 Sep 2024,TO TRANSFER-UPI/DR/498611347053/ROHIT T/ICIC/anitapawar/UPI--,TRANSFER TO 9137022807,4461.72,,-220617.37
28 Sep 2024,BY TRANSFER-UPI/CR/443771451109/PRIYA K/ICIC/rahuldixit/Dr Re--,TRANSFER FROM 4897690162095,,4774.41,-215842.96
1 Aug 2024,BY TRANSFER-UPI/CR/477592925630/PRIYA K/IDIB/rahuldixit/Dr Re--,TRANSFER FROM 9137022807,,1372.15,-214470.81
25 Aug 2024,BY TRANSFER-UPI/CR/427590185439/SAGAR MO/HDFC/rahuldixit/Dr Re--,TRANSFER FROM 4897732162091,,4582.93,-209887.88
5 Jul 2024,TO TRANSFER-UPI/DR/465519576577/SAMEER S/IDIB/rahuldixit/UPI--,TRANSFER TO 4897732162091,3377.55,,-213265.43
27 Jul 2024,BY TRANSFER-UPI/CR/489732369714/ANITA P/IDIB/spawar3290/Dr Re--,TRANSFER FROM 9137022807,,1062.57,-212202.86
19 Aug 2024,TO TRANSFER-UPI/DR/462109633900/ROHIT T/KKBK/spawar3290/UPI--,TRANSFER TO 8974521398,1851.13,,-214053.99
3 Jul 2024,TO TRANSFER-UPI/DR/445424105262/MS SANJE/IDIB/rohit@okhdfc/UPI--,TRANSFER TO 4897732162091,4821.71,,-218875.7
30 Jul 2024,TO TRANSFER-UPI/DR/411238590207/PRIYA K/IDIB/write2same/UPI--,TRANSFER TO 7382910045,2593.3,,-221469.0
2 Jul 2024,BY TRANSFER-UPI/CR/428028592172/SAMEER S/IDIB/write2same/Dr Re--,TRANSFER FROM 4897690162095,,4268.81,-217200.19
7 Sep 2024,TO TRANSFER-UPI/DR/472044104694/PRIYA K/SBIN/rahuldixit/UPI--,TRANSFER TO 8974521398,3154.12,,-220354.31
8 Jul 2024,TO TRANSFER-UPI/DR/492805232035/MS SANJE/KKBK/write2same/UPI--,TRANSFER TO 4897690162095,1073.82,,-221428.13
27 Sep 2024,BY TRANSFER-UPI/CR/407547729517/SAMEER S/SBIN/anitapawar/Dr Re--,TRANSFER FROM 9137022807,,1398.35,-220029.78
6 Aug 2024,BY TRANSFER-UPI/CR/417193228017/MS SANJE/IDIB/write2same/Dr Re--,TRANSFER FROM 4897690162095,,2051.29,-217978.49
22 Sep 2024,TO TRANSFER-UPI/DR/434465422171/ANITA P/IDIB/spawar3290/UPI--,TRANSFER TO 4897690162095,3081.47,,-221059.96
4 Sep 2024,BY TRANSFER-UPI/CR/479713985541/RAHUL D/KKBK/rahuldixit/Dr Re--,TRANSFER FROM 4897690162095,,4182.85,-216877.11
15 Jul 2024,TO TRANSFER-UPI/DR/490410621727/PRIYA K/KKBK/rahuldixit/UPI--,TRANSFER TO 4897690162095,1741.46,,-218618.57
26 Sep 2024,TO TRANSFER-UPI/DR/414032241476/SAGAR MO/IDIB/rahuldixit/UPI--,TRANSFER TO 9137022807,2573.77,,-221192.34
12 Sep 2024,BY TRANSFER-UPI/CR/413828979174/RAHUL D/IDIB/spawar3290/Dr Re--,TRANSFER FROM 7382910045,,2865.26,-218327.08
12 Sep 2024,TO TRANSFER-UPI/DR/411236633979/ANITA P/IDIB/spawar3290/UPI--,TRANSFER TO 7382910045,2751.19,,-221078.27
17 Jul 2024,BY TRANSFER-UPI/CR/431906681198/RAHUL D/KKBK/spawar3290/Dr Re--,TRANSFER FROM 9137022807,,2574.33,-218503.94
5 Aug 2024,BY TRANSFER-UPI/CR/401026415840/RAHUL D/KKBK/rohit@okhdfc/Dr Re--,TRANSFER FROM 4897690162095,,3033.05,-215470.89
22 Aug 2024,BY TRANSFER-UPI/CR/497522801368/SAGAR MO/KKBK/write2same/Dr Re--,TRANSFER FROM 9137022807,,2240.9,-213229.99
30 Jul 2024,BY TRANSFER-UPI/CR/418038453889/ANITA P/KKBK/spawar3290/Dr Re--,TRANSFER FROM 7382910045,,1214.3,-212015.69
17 Sep 2024,BY TRANSFER-UPI/CR/462544280601/SAGAR MO/SBIN/write2same/Dr Re--,TRANSFER FROM 9137022807,,1101.21,-210914.48
19 Sep 2024,BY TRANSFER-UPI/CR/480752801436/ROHIT T/HDFC/write2same/Dr Re--,TRANSFER FROM 4897690162095,,1646.3,-209268.18
10 Jul 2024,BY TRANSFER-UPI/CR/404189840804/SAMEER S/SBIN/write2same/Dr Re--,TRANSFER FROM 4897690162095,,4682.95,-204585.23
23 Aug 2024,TO TRANSFER-UPI/DR/453447330035/PRIYA K/KKBK/anitapawar/UPI--,TRANSFER TO 9137022807,139.92,,-204725.15
6 Aug 2024,BY TRANSFER-UPI/CR/456221703661/PRIYA K/ICIC/rohit@okhdfc/Dr Re--,TRANSFER FROM 8974521398,,3244.1,-201481.05
6 Aug 2024,BY TRANSFER-UPI/CR/432611787227/MS SANJE/KKBK/rahuldixit/Dr Re--,TRANSFER FROM 9137022807,,3230.25,-198250.8
20 Sep 2024,TO TRANSFER-UPI/DR/488187221217/RAHUL D/IDIB/spawar3290/UPI--,TRANSFER TO 7382910045,4174.46,,-202425.26
10 Sep 2024,BY TRANSFER-UPI/CR/483893513347/MS SANJE/KKBK/spawar3290/Dr Re--,TRANSFER FROM 7382910045,,4135.28,-198289.98
7 Aug 2024,TO TRANSFER-UPI/DR/483343537678/SAMEER S/SBIN/rahuldixit/UPI--,TRANSFER TO 4897732162091,1837.66,,-200127.64
15 Aug 2024,TO TRANSFER-UPI/DR/442225927532/SAMEER S/HDFC/spawar3290/UPI--,TRANSFER TO 7382910045,4866.6,,-204994.24
29 Aug 2024,TO TRANSFER-UPI/DR/447172224983/PRIYA K/KKBK/rahuldixit/UPI--,TRANSFER TO 7382910045,448.93,,-205443.17
18 Jul 2024,BY TRANSFER-UPI/CR/415330738100/PRIYA K/ICIC/spawar3290/Dr Re--,TRANSFER FROM 4897732162091,,653.98,-204789.19
7 Aug 2024,TO TRANSFER-UPI/DR/425064640506/SAMEER S/HDFC/anitapawar/UPI--,TRANSFER TO 7382910045,3983.05,,-208772.24
29 Sep 2024,BY TRANSFER-UPI/CR/473891112193/PRIYA K/KKBK/spawar3290/Dr Re--,TRANSFER FROM 7382910045,,711.9,-208060.34
28 Sep 2024,BY TRANSFER-UPI/CR/400984575329/ANITA P/IDIB/write2same/Dr Re--,TRANSFER FROM 7382910045,,4950.1,-203110.24
22 Aug 2024,TO TRANSFER-UPI/DR/423422153411/SAGAR MO/HDFC/rohit@okhdfc/UPI--,TRANSFER TO 8974521398,4501.57,,-207611.81
24 Aug 2024,BY TRANSFER-UPI/CR/407563524594/SAGAR MO/SBIN/rohit@okhdfc/Dr Re--,TRANSFER FROM 9137022807,,2291.12,-205320.69
18 Sep 2024,TO TRANSFER-UPI/DR/423876657654/SAGAR MO/SBIN/anitapawar/UPI--,TRANSFER TO 8974521398,758.4,,-206079.09
8 Jul 2024,BY TRANSFER-UPI/CR/446762606709/SAMEER S/HDFC/spawar3290/Dr Re--,TRANSFER FROM 9137022807,,3051.52,-203027.57
7 Sep 2024,BY TRANSFER-UPI/CR/457289513249/ANITA P/IDIB/anitapawar/Dr Re--,TRANSFER FROM 9137022807,,3652.38,-199375.19
11 Sep 2024,BY TRANSFER-UPI/CR/480049976783/MS SANJE/KKBK/anitapawar/Dr Re--,TRANSFER FROM 4897732162091,,203.47,-199171.72
14 Aug 2024,TO TRANSFER-UPI/DR/427169063339/PRIYA K/IDIB/write2same/UPI--,TRANSFER TO 4897732162091,4439.03,,-203610.75
28 Jul 2024,BY TRANSFER-UPI/CR/492087899748/SAMEER S/SBIN/spawar3290/Dr Re--,TRANSFER FROM 7382910045,,1169.74,-202441.01
9 Sep 2024,TO TRANSFER-UPI/DR/429002345246/SAGAR MO/IDIB/anitapawar/UPI--,TRANSFER TO 9137022807,3964.07,,-206405.08
10 Aug 2024,BY TRANSFER-UPI/CR/468490036346/RAHUL D/HDFC/spawar3290/Dr Re--,TRANSFER FROM 4897732162091,,3858.27,-202546.81
2 Aug 2024,BY TRANSFER-UPI/CR/440593622825/PRIYA K/IDIB/spawar3290/Dr Re--,TRANSFER FROM 4897732162091,,1013.57,-201533.24
24 Jul 2024,TO TRANSFER-UPI/DR/433190070578/PRIYA K/HDFC/spawar3290/UPI--,TRANSFER TO 4897732162091,2486.99,,-204020.23
31 Jul 2024,TO TRANSFER-UPI/DR/485128739549/ANITA P/SBIN/rahuldixit/UPI--,TRANSFER TO 8974521398,2662.53,,-206682.76
6 Aug 2024,BY TRANSFER-UPI/CR/401018200775/PRIYA K/HDFC/rahuldixit/Dr Re--,TRANSFER FROM 8974521398,,1187.53,-205495.23
21 Aug 2024,TO TRANSFER-UPI/DR/440441431434/ANITA P/HDFC/rahuldixit/UPI--,TRANSFER TO 4897732162091,3030.42,,-208525.65
25 Aug 2024,TO TRANSFER-UPI/DR/489929479035/MS SANJE/HDFC/write2same/UPI--,TRANSFER TO 7382910045,4031.3,,-212556.95
3 Aug 2024,TO TRANSFER-UPI/DR/485681168282/ANITA P/HDFC/spawar3290/UPI--,TRANSFER TO 4897690162095,861.35,,-213418.3
